CPRO;PROVINCIA;CMUN;NOMBRE;POB19;HOMBRES;MUJERES
02;Albacete;001;Abengibre;790;379;411
02;Albacete;002;Alatoz;519;291;228
02;Albacete;003;Albacete;173329;84687;88642
02;Albacete;004;Albatana;692;356;336
02;Albacete;005;Alborea;658;337;321
02;Albacete;006;Alcadozo;654;363;291
02;Albacete;007;Alcalá del Júcar;1170;618;552
02;Albacete;008;Alcaraz;1351;703;648
02;Albacete;009;Almansa;24419;12167;12252
02;Albacete;010;Alpera;2265;1174;1091
02;Albacete;011;Ayna;616;327;289
02;Albacete;012;Balazote;2334;1189;1145
02;Albacete;014;Ballestero, El;405;207;198
02;Albacete;013;Balsa de Ves;158;91;67
02;Albacete;015;Barrax;1833;939;894
02;Albacete;016;Bienservida;603;326;277
02;Albacete;017;Bogarra;842;443;399
02;Albacete;018;Bonete;1049;540;509
02;Albacete;019;Bonillo, El;2779;1415;1364
02;Albacete;020;Carcelén;501;271;230
02;Albacete;021;Casas de Juan Núñez;1307;686;621
02;Albacete;022;Casas de Lázaro;363;205;158
02;Albacete;023;Casas de Ves;572;301;271
02;Albacete;024;Casas-Ibáñez;4538;2294;2244
02;Albacete;025;Caudete;9963;5073;4890
02;Albacete;026;Cenizate;1181;597;584
02;Albacete;029;Chinchilla de Monte-Aragón;4206;2196;2010
02;Albacete;027;Corral-Rubio;324;174;150
02;Albacete;028;Cotillas;123;64;59
02;Albacete;030;Elche de la Sierra;3585;1787;1798
02;Albacete;031;Férez;643;317;326
02;Albacete;032;Fuensanta;297;168;129
02;Albacete;033;Fuente-Álamo;2489;1307;1182
02;Albacete;034;Fuentealbilla;1792;914;878
02;Albacete;035;Gineta, La;2512;1304;1208
02;Albacete;036;Golosalvo;104;55;49
02;Albacete;037;Hellín;30306;15162;15144
02;Albacete;038;Herrera, La;326;167;159
02;Albacete;039;Higueruela;1158;602;556
02;Albacete;040;Hoya-Gonzalo;647;345;302
02;Albacete;041;Jorquera;355;193;162
02;Albacete;042;Letur;919;449;470
02;Albacete;043;Lezuza;1358;705;653
02;Albacete;044;Liétor;1175;610;565
02;Albacete;045;Madrigueras;4652;2380;2272
02;Albacete;046;Mahora;1383;706;677
02;Albacete;047;Masegoso;110;59;51
02;Albacete;048;Minaya;1501;774;727
02;Albacete;049;Molinicos;852;441;411
02;Albacete;050;Montalvos;97;52;45
02;Albacete;051;Montealegre del Castillo;2051;1043;1008
02;Albacete;052;Motilleja;571;307;264
02;Albacete;053;Munera;3435;1763;1672
02;Albacete;054;Navas de Jorquera;517;266;251
02;Albacete;055;Nerpio;1191;660;531
02;Albacete;056;Ontur;1987;1009;978
02;Albacete;057;Ossa de Montiel;2307;1154;1153
02;Albacete;058;Paterna del Madera;348;190;158
02;Albacete;060;Peñas de San Pedro;1399;817;582
02;Albacete;059;Peñascosa;334;184;150
02;Albacete;061;Pétrola;692;350;342
02;Albacete;062;Povedilla;430;241;189
02;Albacete;901;Pozo Cañada;2797;1418;1379
02;Albacete;063;Pozohondo;1585;826;759
02;Albacete;064;Pozo-Lorente;409;208;201
02;Albacete;065;Pozuelo;481;255;226
02;Albacete;066;Recueja, La;242;133;109
02;Albacete;067;Riópar;1332;687;645
02;Albacete;068;Robledo;367;200;167
02;Albacete;069;Roda, La;15476;7818;7658
02;Albacete;070;Salobre;480;258;222
02;Albacete;071;San Pedro;1242;627;615
02;Albacete;072;Socovos;1787;920;867
02;Albacete;073;Tarazona de la Mancha;6235;3197;3038
02;Albacete;074;Tobarra;7684;3931;3753
02;Albacete;075;Valdeganga;2028;1038;990
02;Albacete;076;Vianos;346;174;172
02;Albacete;077;Villa de Ves;56;32;24
02;Albacete;078;Villalgordo del Júcar;1094;576;518
02;Albacete;079;Villamalea;4027;2034;1993
02;Albacete;080;Villapalacios;583;304;279
02;Albacete;081;Villarrobledo;25184;12456;12728
02;Albacete;082;Villatoya;109;65;44
02;Albacete;083;Villavaliente;224;136;88
02;Albacete;084;Villaverde de Guadalimar;338;173;165
02;Albacete;085;Viveros;337;176;161
02;Albacete;086;Yeste;2657;1375;1282
03;Alicante/Alacant;002;Agost;4758;2357;2401
03;Alicante/Alacant;003;Agres;565;306;259
03;Alicante/Alacant;004;Aigües;963;505;458
03;Alicante/Alacant;005;Albatera;12279;6260;6019
03;Alicante/Alacant;006;Alcalalí;1278;640;638
03;Alicante/Alacant;007;Alcocer de Planes;230;117;113
03;Alicante/Alacant;008;Alcoleja;173;93;80
03;Alicante/Alacant;009;Alcoy/Alcoi;58994;28866;30128
03;Alicante/Alacant;010;Alfafara;410;202;208
03;Alicante/Alacant;011;Alfàs del Pi, l';20482;10187;10295
03;Alicante/Alacant;012;Algorfa;2935;1461;1474
03;Alicante/Alacant;013;Algueña;1336;668;668
03;Alicante/Alacant;014;Alicante/Alacant;334887;162191;172696
03;Alicante/Alacant;015;Almoradí;20803;10510;10293
03;Alicante/Alacant;016;Almudaina;113;57;56
03;Alicante/Alacant;017;Alqueria d'Asnar, l';493;238;255
03;Alicante/Alacant;018;Altea;22290;10911;11379
03;Alicante/Alacant;019;Aspe;20714;10435;10279
03;Alicante/Alacant;001;Atzúbia, l';632;325;307
03;Alicante/Alacant;020;Balones;131;73;58
03;Alicante/Alacant;021;Banyeres de Mariola;7068;3538;3530
03;Alicante/Alacant;022;Benasau;151;74;77
03;Alicante/Alacant;023;Beneixama;1685;852;833
03;Alicante/Alacant;024;Benejúzar;5402;2699;2703
03;Alicante/Alacant;025;Benferri;1942;1001;941
03;Alicante/Alacant;026;Beniarbeig;2092;1061;1031
03;Alicante/Alacant;027;Beniardá;232;106;126
03;Alicante/Alacant;028;Beniarrés;1118;571;547
03;Alicante/Alacant;030;Benidoleig;1095;545;550
03;Alicante/Alacant;031;Benidorm;68721;34250;34471
03;Alicante/Alacant;032;Benifallim;105;60;45
03;Alicante/Alacant;033;Benifato;140;73;67
03;Alicante/Alacant;029;Benigembla;490;253;237
03;Alicante/Alacant;034;Benijófar;3322;1615;1707
03;Alicante/Alacant;035;Benilloba;724;377;347
03;Alicante/Alacant;036;Benillup;97;47;50
03;Alicante/Alacant;037;Benimantell;483;242;241
03;Alicante/Alacant;038;Benimarfull;409;207;202
03;Alicante/Alacant;039;Benimassot;106;59;47
03;Alicante/Alacant;040;Benimeli;418;187;231
03;Alicante/Alacant;041;Benissa;11005;5415;5590
03;Alicante/Alacant;042;Benitachell/Poble Nou de Benitatxell, el;4276;2106;2170
03;Alicante/Alacant;043;Biar;3671;1799;1872
03;Alicante/Alacant;044;Bigastro;6733;3382;3351
03;Alicante/Alacant;045;Bolulla;420;220;200
03;Alicante/Alacant;046;Busot;2978;1516;1462
03;Alicante/Alacant;049;Callosa de Segura;19038;9714;9324
03;Alicante/Alacant;048;Callosa d'en Sarrià;7373;3762;3611
03;Alicante/Alacant;047;Calp;22725;11480;11245
03;Alicante/Alacant;050;Campello, el;28349;13796;14553
03;Alicante/Alacant;051;Campo de Mirra/Camp de Mirra, el;415;211;204
03;Alicante/Alacant;052;Cañada;1220;606;614
03;Alicante/Alacant;053;Castalla;10124;5149;4975
03;Alicante/Alacant;054;Castell de Castells;449;236;213
03;Alicante/Alacant;075;Castell de Guadalest, el;217;111;106
03;Alicante/Alacant;055;Catral;8639;4307;4332
03;Alicante/Alacant;056;Cocentaina;11511;5868;5643
03;Alicante/Alacant;057;Confrides;187;106;81
03;Alicante/Alacant;058;Cox;7297;3722;3575
03;Alicante/Alacant;059;Crevillent;28952;14627;14325
03;Alicante/Alacant;061;Daya Nueva;1737;852;885
03;Alicante/Alacant;062;Daya Vieja;690;354;336
03;Alicante/Alacant;063;Dénia;42166;20419;21747
03;Alicante/Alacant;064;Dolores;7470;3740;3730
03;Alicante/Alacant;065;Elche/Elx;232517;115151;117366
03;Alicante/Alacant;066;Elda;52618;25639;26979
03;Alicante/Alacant;067;Facheca;106;52;54
03;Alicante/Alacant;068;Famorca;47;24;23
03;Alicante/Alacant;069;Finestrat;6715;3440;3275
03;Alicante/Alacant;077;Fondó de les Neus, el/Hondón de las Nieves;2544;1306;1238
03;Alicante/Alacant;070;Formentera del Segura;4191;2105;2086
03;Alicante/Alacant;072;Gaianes;452;227;225
03;Alicante/Alacant;071;Gata de Gorgos;6049;3082;2967
03;Alicante/Alacant;073;Gorga;249;140;109
03;Alicante/Alacant;074;Granja de Rocamora;2580;1362;1218
03;Alicante/Alacant;076;Guardamar del Segura;15348;7492;7856
03;Alicante/Alacant;078;Hondón de los Frailes;1198;616;582
03;Alicante/Alacant;079;Ibi;23489;11747;11742
03;Alicante/Alacant;080;Jacarilla;2022;1030;992
03;Alicante/Alacant;082;Jávea/Xàbia;27604;13681;13923
03;Alicante/Alacant;083;Jijona/Xixona;6865;3342;3523
03;Alicante/Alacant;085;Llíber;935;474;461
03;Alicante/Alacant;084;Lorcha/Orxa, l';578;284;294
03;Alicante/Alacant;086;Millena;237;127;110
03;Alicante/Alacant;088;Monforte del Cid;8165;4292;3873
03;Alicante/Alacant;089;Monóvar/Monòver;12167;6069;6098
03;Alicante/Alacant;903;Montesinos, Los;4968;2520;2448
03;Alicante/Alacant;091;Murla;470;220;250
03;Alicante/Alacant;092;Muro de Alcoy;9324;4637;4687
03;Alicante/Alacant;090;Mutxamel;25352;12662;12690
03;Alicante/Alacant;093;Novelda;25651;12770;12881
03;Alicante/Alacant;094;Nucia, la;18603;9425;9178
03;Alicante/Alacant;095;Ondara;6894;3460;3434
03;Alicante/Alacant;096;Onil;7507;3757;3750
03;Alicante/Alacant;097;Orba;2174;1074;1100
03;Alicante/Alacant;099;Orihuela;77414;38360;39054
03;Alicante/Alacant;098;Orxeta;736;379;357
03;Alicante/Alacant;100;Parcent;929;446;483
03;Alicante/Alacant;101;Pedreguer;7699;3809;3890
03;Alicante/Alacant;102;Pego;10128;5057;5071
03;Alicante/Alacant;103;Penàguila;292;152;140
03;Alicante/Alacant;104;Petrer;34276;17039;17237
03;Alicante/Alacant;902;Pilar de la Horadada;21905;11236;10669
03;Alicante/Alacant;105;Pinós, el/Pinoso;7966;4026;3940
03;Alicante/Alacant;106;Planes;693;375;318
03;Alicante/Alacant;901;Poblets, els;2705;1276;1429
03;Alicante/Alacant;107;Polop;4965;2541;2424
03;Alicante/Alacant;060;Quatretondeta;122;66;56
03;Alicante/Alacant;109;Rafal;4498;2240;2258
03;Alicante/Alacant;110;Ràfol d'Almúnia, el;653;334;319
03;Alicante/Alacant;111;Redován;7869;4069;3800
03;Alicante/Alacant;112;Relleu;1160;599;561
03;Alicante/Alacant;113;Rojales;16963;8617;8346
03;Alicante/Alacant;114;Romana, la;2434;1263;1171
03;Alicante/Alacant;115;Sagra;408;198;210
03;Alicante/Alacant;116;Salinas;1601;826;775
03;Alicante/Alacant;118;San Fulgencio;7855;3964;3891
03;Alicante/Alacant;904;San Isidro;1986;1024;962
03;Alicante/Alacant;120;San Miguel de Salinas;6034;3044;2990
03;Alicante/Alacant;122;San Vicente del Raspeig/Sant Vicent del Raspeig;58385;28864;29521
03;Alicante/Alacant;117;Sanet y Negrals;667;341;326
03;Alicante/Alacant;119;Sant Joan d'Alacant;23915;11538;12377
03;Alicante/Alacant;121;Santa Pola;32306;16225;16081
03;Alicante/Alacant;123;Sax;9845;4968;4877
03;Alicante/Alacant;124;Sella;580;306;274
03;Alicante/Alacant;125;Senija;584;302;282
03;Alicante/Alacant;127;Tàrbena;646;335;311
03;Alicante/Alacant;128;Teulada;11112;5541;5571
03;Alicante/Alacant;129;Tibi;1614;851;763
03;Alicante/Alacant;130;Tollos;57;30;27
03;Alicante/Alacant;131;Tormos;340;163;177
03;Alicante/Alacant;132;Torremanzanas/Torre de les Maçanes, la;661;352;309
03;Alicante/Alacant;133;Torrevieja;83337;41269;42068
03;Alicante/Alacant;134;Vall d'Alcalà, la;167;92;75
03;Alicante/Alacant;136;Vall de Gallinera;571;304;267
03;Alicante/Alacant;137;Vall de Laguar, la;846;427;419
03;Alicante/Alacant;135;Vall d'Ebo, la;216;111;105
03;Alicante/Alacant;138;Verger, el;4640;2302;2338
03;Alicante/Alacant;139;Villajoyosa/Vila Joiosa, la;34673;17296;17377
03;Alicante/Alacant;140;Villena;33964;17056;16908
03;Alicante/Alacant;081;Xaló;2739;1378;1361
04;Almería;001;Abla;1249;635;614
04;Almería;002;Abrucena;1202;637;565
04;Almería;003;Adra;25148;12833;12315
04;Almería;004;Albanchez;741;379;362
04;Almería;005;Alboloduy;616;302;314
04;Almería;006;Albox;11805;6031;5774
04;Almería;007;Alcolea;825;428;397
04;Almería;008;Alcóntar;505;278;227
04;Almería;009;Alcudia de Monteagud;152;73;79
04;Almería;010;Alhabia;671;351;320
04;Almería;011;Alhama de Almería;3641;1829;1812
04;Almería;012;Alicún;206;110;96
04;Almería;013;Almería;198533;96995;101538
04;Almería;014;Almócita;169;88;81
04;Almería;015;Alsodux;125;75;50
04;Almería;016;Antas;3182;1614;1568
04;Almería;017;Arboleas;4596;2312;2284
04;Almería;018;Armuña de Almanzora;302;144;158
04;Almería;019;Bacares;246;130;116
04;Almería;904;Balanegra;3009;1583;1426
04;Almería;020;Bayárcal;317;171;146
04;Almería;021;Bayarque;215;102;113
04;Almería;022;Bédar;971;491;480
04;Almería;023;Beires;110;56;54
04;Almería;024;Benahadux;4382;2160;2222
04;Almería;026;Benitagla;58;32;26
04;Almería;027;Benizalón;254;135;119
04;Almería;028;Bentarique;238;133;105
04;Almería;029;Berja;12415;6293;6122
04;Almería;030;Canjáyar;1214;641;573
04;Almería;031;Cantoria;3204;1625;1579
04;Almería;032;Carboneras;8004;4120;3884
04;Almería;033;Castro de Filabres;123;61;62
04;Almería;036;Chercos;278;142;136
04;Almería;037;Chirivel;1472;748;724
04;Almería;034;Cóbdar;171;99;72
04;Almería;035;Cuevas del Almanzora;14081;7343;6738
04;Almería;038;Dalías;4006;1988;2018
04;Almería;902;Ejido, El;83594;43596;39998
04;Almería;041;Enix;466;259;207
04;Almería;043;Felix;628;357;271
04;Almería;044;Fines;2079;1093;986
04;Almería;045;Fiñana;1994;1002;992
04;Almería;046;Fondón;989;514;475
04;Almería;047;Gádor;3012;1569;1443
04;Almería;048;Gallardos, Los;2794;1408;1386
04;Almería;049;Garrucha;9212;4763;4449
04;Almería;050;Gérgal;1030;543;487
04;Almería;051;Huécija;480;233;247
04;Almería;052;Huércal de Almería;17651;8959;8692
04;Almería;053;Huércal-Overa;19127;9514;9613
04;Almería;054;Íllar;394;211;183
04;Almería;055;Instinción;448;233;215
04;Almería;056;Laroya;192;111;81
04;Almería;057;Láujar de Andarax;1536;766;770
04;Almería;058;Líjar;390;207;183
04;Almería;059;Lubrín;1477;736;741
04;Almería;060;Lucainena de las Torres;538;287;251
04;Almería;061;Lúcar;763;373;390
04;Almería;062;Macael;5482;2803;2679
04;Almería;063;María;1238;637;601
04;Almería;064;Mojácar;6403;3132;3271
04;Almería;903;Mojonera, La;9021;5075;3946
04;Almería;065;Nacimiento;495;255;240
04;Almería;066;Níjar;30663;17075;13588
04;Almería;067;Ohanes;580;292;288
04;Almería;068;Olula de Castro;196;109;87
04;Almería;069;Olula del Río;6210;3182;3028
04;Almería;070;Oria;2249;1170;1079
04;Almería;071;Padules;410;208;202
04;Almería;072;Partaloa;1110;564;546
04;Almería;073;Paterna del Río;371;215;156
04;Almería;074;Pechina;4037;2043;1994
04;Almería;075;Pulpí;10055;5283;4772
04;Almería;076;Purchena;1618;851;767
04;Almería;077;Rágol;316;166;150
04;Almería;078;Rioja;1417;720;697
04;Almería;079;Roquetas de Mar;96800;50110;46690
04;Almería;080;Santa Cruz de Marchena;208;103;105
04;Almería;081;Santa Fe de Mondújar;452;234;218
04;Almería;082;Senés;295;156;139
04;Almería;083;Serón;2041;1044;997
04;Almería;084;Sierro;381;204;177
04;Almería;085;Somontín;446;228;218
04;Almería;086;Sorbas;2388;1254;1134
04;Almería;087;Suflí;204;109;95
04;Almería;088;Tabernas;3688;1898;1790
04;Almería;089;Taberno;925;450;475
04;Almería;090;Tahal;362;177;185
04;Almería;091;Terque;377;198;179
04;Almería;092;Tíjola;3541;1763;1778
04;Almería;901;Tres Villas, Las;568;307;261
04;Almería;093;Turre;3549;1819;1730
04;Almería;094;Turrillas;240;138;102
04;Almería;095;Uleila del Campo;833;418;415
04;Almería;096;Urrácal;350;182;168
04;Almería;097;Velefique;242;133;109
04;Almería;098;Vélez-Blanco;1904;981;923
04;Almería;099;Vélez-Rubio;6555;3207;3348
04;Almería;100;Vera;16452;8396;8056
04;Almería;101;Viator;5885;3004;2881
04;Almería;102;Vícar;26028;14017;12011
04;Almería;103;Zurgena;3005;1490;1515
01;Araba/Álava;051;Agurain/Salvatierra;5062;2526;2536
01;Araba/Álava;001;Alegría-Dulantzi;2876;1501;1375
01;Araba/Álava;002;Amurrio;10350;5100;5250
01;Araba/Álava;049;Añana;156;95;61
01;Araba/Álava;003;Aramaio;1467;764;703
01;Araba/Álava;006;Armiñón;227;119;108
01;Araba/Álava;037;Arraia-Maeztu;726;403;323
01;Araba/Álava;008;Arratzua-Ubarrundia;980;529;451
01;Araba/Álava;004;Artziniega;1821;906;915
01;Araba/Álava;009;Asparrena;1614;826;788
01;Araba/Álava;010;Ayala/Aiara;2974;1500;1474
01;Araba/Álava;011;Baños de Ebro/Mañueta;291;163;128
01;Araba/Álava;013;Barrundia;883;491;392
01;Araba/Álava;014;Berantevilla;453;243;210
01;Araba/Álava;016;Bernedo;494;299;195
01;Araba/Álava;017;Campezo/Kanpezu;1040;546;494
01;Araba/Álava;021;Elburgo/Burgelu;599;320;279
01;Araba/Álava;022;Elciego;1005;502;503
01;Araba/Álava;023;Elvillar/Bilar;333;162;171
01;Araba/Álava;047;Erriberabeitia;1350;724;626
01;Araba/Álava;046;Erriberagoitia/Ribera Alta;785;453;332
01;Araba/Álava;056;Harana/Valle de Arana;221;124;97
01;Araba/Álava;901;Iruña Oka/Iruña de Oca;3411;1769;1642
01;Araba/Álava;027;Iruraiz-Gauna;517;281;236
01;Araba/Álava;019;Kripan;180;94;86
01;Araba/Álava;020;Kuartango;376;220;156
01;Araba/Álava;028;Labastida/Bastida;1452;751;701
01;Araba/Álava;030;Lagrán;157;87;70
01;Araba/Álava;031;Laguardia;1494;767;727
01;Araba/Álava;032;Lanciego/Lantziego;691;367;324
01;Araba/Álava;902;Lantarón;875;494;381
01;Araba/Álava;033;Lapuebla de Labarca;865;439;426
01;Araba/Álava;036;Laudio/Llodio;18102;8868;9234
01;Araba/Álava;058;Legutio;1885;995;890
01;Araba/Álava;034;Leza;203;100;103
01;Araba/Álava;039;Moreda de Álava/Moreda Araba;221;108;113
01;Araba/Álava;041;Navaridas;200;112;88
01;Araba/Álava;042;Okondo;1188;611;577
01;Araba/Álava;043;Oyón-Oion;3386;1708;1678
01;Araba/Álava;044;Peñacerrada-Urizaharra;261;152;109
01;Araba/Álava;052;Samaniego;316;158;158
01;Araba/Álava;053;San Millán/Donemiliaga;715;393;322
01;Araba/Álava;054;Urkabustaiz;1371;716;655
01;Araba/Álava;055;Valdegovía/Gaubea;996;553;443
01;Araba/Álava;057;Villabuena de Álava/Eskuernaga;296;149;147
01;Araba/Álava;059;Vitoria-Gasteiz;251774;122711;129063
01;Araba/Álava;060;Yécora/Iekora;268;140;128
01;Araba/Álava;061;Zalduondo;183;103;80
01;Araba/Álava;062;Zambrana;410;223;187
01;Araba/Álava;018;Zigoitia;1747;944;803
01;Araba/Álava;063;Zuia;2302;1190;1112
33;Asturias;001;Allande;1648;833;815
33;Asturias;002;Aller;10613;5248;5365
33;Asturias;003;Amieva;661;378;283
33;Asturias;004;Avilés;78182;36993;41189
33;Asturias;005;Belmonte de Miranda;1489;787;702
33;Asturias;006;Bimenes;1681;803;878
33;Asturias;007;Boal;1505;755;750
33;Asturias;008;Cabrales;1960;1001;959
33;Asturias;009;Cabranes;1034;519;515
33;Asturias;010;Candamo;1947;950;997
33;Asturias;012;Cangas de Onís;6163;2997;3166
33;Asturias;011;Cangas del Narcea;12347;6070;6277
33;Asturias;013;Caravia;477;246;231
33;Asturias;014;Carreño;10337;4977;5360
33;Asturias;015;Caso;1507;873;634
33;Asturias;016;Castrillón;22376;10849;11527
33;Asturias;017;Castropol;3402;1661;1741
33;Asturias;018;Coaña;3315;1607;1708
33;Asturias;019;Colunga;3257;1599;1658
33;Asturias;020;Corvera de Asturias;15549;7622;7927
33;Asturias;021;Cudillero;4987;2448;2539
33;Asturias;022;Degaña;921;478;443
33;Asturias;023;Franco, El;3796;1865;1931
33;Asturias;024;Gijón;271780;128128;143652
33;Asturias;025;Gozón;10333;5047;5286
33;Asturias;026;Grado;9784;4746;5038
33;Asturias;027;Grandas de Salime;835;426;409
33;Asturias;028;Ibias;1251;718;533
33;Asturias;029;Illano;346;173;173
33;Asturias;030;Illas;1014;512;502
33;Asturias;031;Langreo;39420;18787;20633
33;Asturias;032;Laviana;12977;6214;6763
33;Asturias;033;Lena;10890;5223;5667
33;Asturias;035;Llanera;13702;6792;6910
33;Asturias;036;Llanes;13568;6584;6984
33;Asturias;037;Mieres;37959;18015;19944
33;Asturias;038;Morcín;2594;1303;1291
33;Asturias;039;Muros de Nalón;1871;898;973
33;Asturias;040;Nava;5321;2616;2705
33;Asturias;041;Navia;8380;4033;4347
33;Asturias;042;Noreña;5179;2478;2701
33;Asturias;043;Onís;743;402;341
33;Asturias;044;Oviedo;219686;101732;117954
33;Asturias;045;Parres;5336;2588;2748
33;Asturias;046;Peñamellera Alta;514;271;243
33;Asturias;047;Peñamellera Baja;1226;606;620
33;Asturias;048;Pesoz;147;82;65
33;Asturias;049;Piloña;6973;3436;3537
33;Asturias;050;Ponga;586;343;243
33;Asturias;051;Pravia;8113;3918;4195
33;Asturias;052;Proaza;744;431;313
33;Asturias;053;Quirós;1158;671;487
33;Asturias;054;Regueras, Las;1826;941;885
33;Asturias;055;Ribadedeva;1756;848;908
33;Asturias;056;Ribadesella;5746;2731;3015
33;Asturias;057;Ribera de Arriba;1854;926;928
33;Asturias;058;Riosa;1858;931;927
33;Asturias;059;Salas;4959;2449;2510
33;Asturias;061;San Martín de Oscos;377;193;184
33;Asturias;060;San Martín del Rey Aurelio;16074;7688;8386
33;Asturias;063;San Tirso de Abres;410;203;207
33;Asturias;062;Santa Eulalia de Oscos;450;234;216
33;Asturias;064;Santo Adriano;288;144;144
33;Asturias;065;Sariego;1252;604;648
33;Asturias;066;Siero;51667;25255;26412
33;Asturias;067;Sobrescobio;811;433;378
33;Asturias;068;Somiedo;1153;676;477
33;Asturias;069;Soto del Barco;3866;1916;1950
33;Asturias;070;Tapia de Casariego;3786;1841;1945
33;Asturias;071;Taramundi;623;297;326
33;Asturias;072;Teverga;1572;856;716
33;Asturias;073;Tineo;9389;4748;4641
33;Asturias;034;Valdés;11504;5619;5885
33;Asturias;074;Vegadeo;3926;1884;2042
33;Asturias;075;Villanueva de Oscos;292;146;146
33;Asturias;076;Villaviciosa;14439;7146;7293
33;Asturias;077;Villayón;1206;623;583
33;Asturias;078;Yernes y Tameza;132;73;59
05;Ávila;001;Adanero;196;111;85
05;Ávila;002;Adrada, La;2480;1286;1194
05;Ávila;005;Albornos;183;98;85
05;Ávila;007;Aldeanueva de Santa Cruz;118;62;56
05;Ávila;008;Aldeaseca;238;116;122
05;Ávila;010;Aldehuela, La;162;83;79
05;Ávila;012;Amavida;132;70;62
05;Ávila;013;Arenal, El;973;497;476
05;Ávila;014;Arenas de San Pedro;6377;3105;3272
05;Ávila;015;Arevalillo;73;35;38
05;Ávila;016;Arévalo;7986;3877;4109
05;Ávila;017;Aveinte;86;50;36
05;Ávila;018;Avellaneda;24;14;10
05;Ávila;019;Ávila;57744;27474;30270
05;Ávila;021;Barco de Ávila, El;2312;1123;1189
05;Ávila;022;Barraco, El;1861;955;906
05;Ávila;023;Barromán;185;100;85
05;Ávila;024;Becedas;196;105;91
05;Ávila;025;Becedillas;84;46;38
05;Ávila;026;Bercial de Zapardiel;200;106;94
05;Ávila;027;Berlanas, Las;319;168;151
05;Ávila;029;Bernuy-Zapardiel;102;60;42
05;Ávila;030;Berrocalejo de Aragona;46;24;22
05;Ávila;033;Blascomillán;193;103;90
05;Ávila;034;Blasconuño de Matacabras;16;8;8
05;Ávila;035;Blascosancho;105;53;52
05;Ávila;036;Bohodón, El;120;60;60
05;Ávila;037;Bohoyo;237;135;102
05;Ávila;038;Bonilla de la Sierra;120;71;49
05;Ávila;039;Brabos;46;29;17
05;Ávila;040;Bularros;66;43;23
05;Ávila;041;Burgohondo;1195;622;573
05;Ávila;042;Cabezas de Alambre;157;78;79
05;Ávila;043;Cabezas del Pozo;75;41;34
05;Ávila;044;Cabezas del Villar;260;142;118
05;Ávila;045;Cabizuela;84;43;41
05;Ávila;046;Canales;45;25;20
05;Ávila;047;Candeleda;5018;2536;2482
05;Ávila;048;Cantiveros;103;59;44
05;Ávila;049;Cardeñosa;447;240;207
05;Ávila;051;Carrera, La;175;96;79
05;Ávila;052;Casas del Puerto;89;47;42
05;Ávila;053;Casasola;75;45;30
05;Ávila;054;Casavieja;1424;736;688
05;Ávila;055;Casillas;638;334;304
05;Ávila;056;Castellanos de Zapardiel;97;54;43
05;Ávila;057;Cebreros;3120;1614;1506
05;Ávila;058;Cepeda la Mora;74;42;32
05;Ávila;067;Chamartín;76;45;31
05;Ávila;059;Cillán;93;56;37
05;Ávila;060;Cisla;102;50;52
05;Ávila;061;Colilla, La;336;175;161
05;Ávila;062;Collado de Contreras;168;85;83
05;Ávila;063;Collado del Mirón;32;21;11
05;Ávila;064;Constanzana;108;63;45
05;Ávila;065;Crespos;495;265;230
05;Ávila;066;Cuevas del Valle;484;267;217
05;Ávila;903;Diego del Carpio;139;79;60
05;Ávila;069;Donjimeno;78;44;34
05;Ávila;070;Donvidas;34;18;16
05;Ávila;072;Espinosa de los Caballeros;114;62;52
05;Ávila;073;Flores de Ávila;306;168;138
05;Ávila;074;Fontiveros;748;387;361
05;Ávila;075;Fresnedilla;116;58;58
05;Ávila;076;Fresno, El;589;310;279
05;Ávila;077;Fuente el Saúz;170;91;79
05;Ávila;078;Fuentes de Año;100;58;42
05;Ávila;079;Gallegos de Altamiros;70;39;31
05;Ávila;080;Gallegos de Sobrinos;42;21;21
05;Ávila;081;Garganta del Villar;39;27;12
05;Ávila;082;Gavilanes;586;312;274
05;Ávila;083;Gemuño;156;81;75
05;Ávila;085;Gil García;35;17;18
05;Ávila;084;Gilbuena;64;37;27
05;Ávila;086;Gimialcón;75;47;28
05;Ávila;087;Gotarrendura;162;56;106
05;Ávila;088;Grandes y San Martín;27;13;14
05;Ávila;089;Guisando;497;249;248
05;Ávila;090;Gutierre-Muñoz;78;39;39
05;Ávila;092;Hernansancho;159;93;66
05;Ávila;093;Herradón de Pinares;413;228;185
05;Ávila;094;Herreros de Suso;126;69;57
05;Ávila;095;Higuera de las Dueñas;262;148;114
05;Ávila;096;Hija de Dios, La;80;49;31
05;Ávila;097;Horcajada, La;508;265;243
05;Ávila;099;Horcajo de las Torres;505;281;224
05;Ávila;100;Hornillo, El;290;153;137
05;Ávila;102;Hoyo de Pinares, El;2131;1101;1030
05;Ávila;101;Hoyocasero;293;173;120
05;Ávila;103;Hoyorredondo;63;33;30
05;Ávila;106;Hoyos de Miguel Muñoz;28;15;13
05;Ávila;104;Hoyos del Collado;33;19;14
05;Ávila;105;Hoyos del Espino;383;211;172
05;Ávila;107;Hurtumpascual;51;32;19
05;Ávila;108;Junciana;38;20;18
05;Ávila;109;Langa;478;253;225
05;Ávila;110;Lanzahíta;828;423;405
05;Ávila;113;Llanos de Tormes, Los;60;27;33
05;Ávila;112;Losar del Barco, El;105;53;52
05;Ávila;114;Madrigal de las Altas Torres;1415;717;698
05;Ávila;115;Maello;594;308;286
05;Ávila;116;Malpartida de Corneja;99;50;49
05;Ávila;117;Mamblas;204;117;87
05;Ávila;118;Mancera de Arriba;74;38;36
05;Ávila;119;Manjabálago y Ortigosa de Rioalmar;24;15;9
05;Ávila;120;Marlín;30;19;11
05;Ávila;121;Martiherrero;312;158;154
05;Ávila;122;Martínez;116;60;56
05;Ávila;123;Mediana de Voltoya;112;55;57
05;Ávila;124;Medinilla;95;43;52
05;Ávila;125;Mengamuñoz;59;29;30
05;Ávila;126;Mesegar de Corneja;62;36;26
05;Ávila;127;Mijares;701;383;318
05;Ávila;128;Mingorría;387;204;183
05;Ávila;129;Mirón, El;122;72;50
05;Ávila;130;Mironcillo;102;53;49
05;Ávila;131;Mirueña de los Infanzones;95;54;41
05;Ávila;132;Mombeltrán;991;507;484
05;Ávila;133;Monsalupe;71;36;35
05;Ávila;134;Moraleja de Matacabras;52;30;22
05;Ávila;135;Muñana;375;201;174
05;Ávila;136;Muñico;89;47;42
05;Ávila;138;Muñogalindo;326;167;159
05;Ávila;139;Muñogrande;66;38;28
05;Ávila;140;Muñomer del Peco;118;64;54
05;Ávila;141;Muñopepe;100;56;44
05;Ávila;142;Muñosancho;92;44;48
05;Ávila;143;Muñotello;62;31;31
05;Ávila;144;Narrillos del Álamo;72;37;35
05;Ávila;145;Narrillos del Rebollar;48;27;21
05;Ávila;149;Narros de Saldueña;103;61;42
05;Ávila;147;Narros del Castillo;155;85;70
05;Ávila;148;Narros del Puerto;24;12;12
05;Ávila;152;Nava de Arévalo;735;386;349
05;Ávila;153;Nava del Barco;84;45;39
05;Ávila;151;Navacepedilla de Corneja;92;46;46
05;Ávila;154;Navadijos;37;25;12
05;Ávila;155;Navaescurial;51;31;20
05;Ávila;156;Navahondilla;304;178;126
05;Ávila;157;Navalacruz;247;137;110
05;Ávila;158;Navalmoral;326;175;151
05;Ávila;159;Navalonguilla;226;114;112
05;Ávila;160;Navalosa;308;173;135
05;Ávila;161;Navalperal de Pinares;770;401;369
05;Ávila;162;Navalperal de Tormes;82;42;40
05;Ávila;163;Navaluenga;1954;970;984
05;Ávila;164;Navaquesera;16;8;8
05;Ávila;165;Navarredonda de Gredos;434;217;217
05;Ávila;166;Navarredondilla;172;87;85
05;Ávila;167;Navarrevisca;261;146;115
05;Ávila;168;Navas del Marqués, Las;5119;2608;2511
05;Ávila;169;Navatalgordo;233;133;100
05;Ávila;170;Navatejares;55;25;30
05;Ávila;171;Neila de San Miguel;65;34;31
05;Ávila;172;Niharra;180;104;76
05;Ávila;173;Ojos-Albos;82;50;32
05;Ávila;174;Orbita;75;39;36
05;Ávila;175;Oso, El;160;92;68
05;Ávila;176;Padiernos;271;149;122
05;Ávila;177;Pajares de Adaja;149;81;68
05;Ávila;178;Palacios de Goda;400;207;193
05;Ávila;179;Papatrigo;226;113;113
05;Ávila;180;Parral, El;67;36;31
05;Ávila;181;Pascualcobo;45;29;16
05;Ávila;182;Pedro Bernardo;817;432;385
05;Ávila;183;Pedro-Rodríguez;134;71;63
05;Ávila;184;Peguerinos;272;155;117
05;Ávila;185;Peñalba de Ávila;102;55;47
05;Ávila;186;Piedrahíta;1822;882;940
05;Ávila;187;Piedralaves;2061;1024;1037
05;Ávila;188;Poveda;42;27;15
05;Ávila;189;Poyales del Hoyo;453;242;211
05;Ávila;190;Pozanco;49;30;19
05;Ávila;191;Pradosegar;124;62;62
05;Ávila;192;Puerto Castilla;106;64;42
05;Ávila;193;Rasueros;182;101;81
05;Ávila;194;Riocabado;140;79;61
05;Ávila;195;Riofrío;215;126;89
05;Ávila;196;Rivilla de Barajas;62;28;34
05;Ávila;197;Salobral;113;62;51
05;Ávila;198;Salvadiós;73;34;39
05;Ávila;199;San Bartolomé de Béjar;37;19;18
05;Ávila;200;San Bartolomé de Corneja;46;23;23
05;Ávila;201;San Bartolomé de Pinares;541;294;247
05;Ávila;206;San Esteban de los Patos;31;20;11
05;Ávila;208;San Esteban de Zapardiel;37;23;14
05;Ávila;207;San Esteban del Valle;720;372;348
05;Ávila;209;San García de Ingelmos;75;47;28
05;Ávila;901;San Juan de Gredos;256;139;117
05;Ávila;210;San Juan de la Encinilla;82;40;42
05;Ávila;211;San Juan de la Nava;468;251;217
05;Ávila;212;San Juan del Molinillo;197;114;83
05;Ávila;213;San Juan del Olmo;97;61;36
05;Ávila;214;San Lorenzo de Tormes;31;17;14
05;Ávila;215;San Martín de la Vega del Alberche;168;97;71
05;Ávila;216;San Martín del Pimpollar;189;112;77
05;Ávila;217;San Miguel de Corneja;57;32;25
05;Ávila;218;San Miguel de Serrezuela;115;62;53
05;Ávila;219;San Pascual;44;26;18
05;Ávila;220;San Pedro del Arroyo;431;231;200
05;Ávila;231;San Vicente de Arévalo;169;99;70
05;Ávila;204;Sanchidrián;716;365;351
05;Ávila;205;Sanchorreja;84;42;42
05;Ávila;222;Santa Cruz de Pinares;159;83;76
05;Ávila;221;Santa Cruz del Valle;341;177;164
05;Ávila;226;Santa María de los Caballeros;66;39;27
05;Ávila;224;Santa María del Arroyo;105;55;50
05;Ávila;225;Santa María del Berrocal;392;208;184
05;Ávila;902;Santa María del Cubillo;317;183;134
05;Ávila;227;Santa María del Tiétar;445;232;213
05;Ávila;228;Santiago del Collado;173;110;63
05;Ávila;904;Santiago del Tormes;118;68;50
05;Ávila;229;Santo Domingo de las Posadas;86;44;42
05;Ávila;230;Santo Tomé de Zabarcos;65;35;30
05;Ávila;232;Serrada, La;117;60;57
05;Ávila;233;Serranillos;247;139;108
05;Ávila;234;Sigeres;46;23;23
05;Ávila;235;Sinlabajos;142;73;69
05;Ávila;236;Solana de Ávila;110;64;46
05;Ávila;237;Solana de Rioalmar;159;93;66
05;Ávila;238;Solosancho;827;437;390
05;Ávila;239;Sotalbo;256;141;115
05;Ávila;240;Sotillo de la Adrada;4590;2269;2321
05;Ávila;241;Tiemblo, El;4109;2086;2023
05;Ávila;242;Tiñosillos;787;405;382
05;Ávila;243;Tolbaños;82;45;37
05;Ávila;244;Tormellas;40;26;14
05;Ávila;245;Tornadizos de Ávila;417;212;205
05;Ávila;247;Torre, La;239;132;107
05;Ávila;246;Tórtoles;51;30;21
05;Ávila;249;Umbrías;99;53;46
05;Ávila;251;Vadillo de la Sierra;60;39;21
05;Ávila;252;Valdecasa;61;36;25
05;Ávila;253;Vega de Santa María;83;41;42
05;Ávila;254;Velayos;211;109;102
05;Ávila;256;Villaflor;113;60;53
05;Ávila;257;Villafranca de la Sierra;134;77;57
05;Ávila;905;Villanueva de Ávila;226;118;108
05;Ávila;258;Villanueva de Gómez;115;65;50
05;Ávila;259;Villanueva del Aceral;118;59;59
05;Ávila;260;Villanueva del Campillo;101;56;45
05;Ávila;261;Villar de Corneja;33;19;14
05;Ávila;262;Villarejo del Valle;347;183;164
05;Ávila;263;Villatoro;162;94;68
05;Ávila;264;Viñegra de Moraña;57;32;25
05;Ávila;265;Vita;84;49;35
05;Ávila;266;Zapardiel de la Cañada;94;50;44
05;Ávila;267;Zapardiel de la Ribera;116;60;56
06;Badajoz;001;Acedera;807;416;391
06;Badajoz;002;Aceuchal;5449;2711;2738
06;Badajoz;003;Ahillones;871;430;441
06;Badajoz;004;Alange;1848;935;913
06;Badajoz;005;Albuera, La;2028;1064;964
06;Badajoz;006;Alburquerque;5343;2659;2684
06;Badajoz;007;Alconchel;1680;846;834
06;Badajoz;008;Alconera;744;366;378
06;Badajoz;009;Aljucén;264;146;118
06;Badajoz;010;Almendral;1232;606;626
06;Badajoz;011;Almendralejo;33474;16595;16879
06;Badajoz;012;Arroyo de San Serván;4107;2085;2022
06;Badajoz;013;Atalaya;301;154;147
06;Badajoz;014;Azuaga;7853;3893;3960
06;Badajoz;015;Badajoz;150702;73078;77624
06;Badajoz;016;Barcarrota;3510;1777;1733
06;Badajoz;017;Baterno;283;151;132
06;Badajoz;018;Benquerencia de la Serena;829;413;416
06;Badajoz;019;Berlanga;2343;1165;1178
06;Badajoz;020;Bienvenida;2087;1071;1016
06;Badajoz;021;Bodonal de la Sierra;1049;542;507
06;Badajoz;022;Burguillos del Cerro;3057;1508;1549
06;Badajoz;023;Cabeza del Buey;4864;2407;2457
06;Badajoz;024;Cabeza la Vaca;1309;669;640
06;Badajoz;025;Calamonte;6162;3058;3104
06;Badajoz;026;Calera de León;960;486;474
06;Badajoz;027;Calzadilla de los Barros;755;375;380
06;Badajoz;028;Campanario;4896;2403;2493
06;Badajoz;029;Campillo de Llerena;1360;689;671
06;Badajoz;030;Capilla;182;96;86
06;Badajoz;031;Carmonita;540;274;266
06;Badajoz;032;Carrascalejo, El;83;42;41
06;Badajoz;033;Casas de Don Pedro;1439;745;694
06;Badajoz;034;Casas de Reina;196;95;101
06;Badajoz;035;Castilblanco;951;484;467
06;Badajoz;036;Castuera;5880;2898;2982
06;Badajoz;042;Cheles;1176;570;606
06;Badajoz;037;Codosera, La;2075;1097;978
06;Badajoz;038;Cordobilla de Lácara;909;472;437
06;Badajoz;039;Coronada, La;2162;1057;1105
06;Badajoz;040;Corte de Peleas;1222;602;620
06;Badajoz;041;Cristina;552;283;269
06;Badajoz;043;Don Álvaro;788;405;383
06;Badajoz;044;Don Benito;37151;18362;18789
06;Badajoz;045;Entrín Bajo;551;280;271
06;Badajoz;046;Esparragalejo;1462;722;740
06;Badajoz;047;Esparragosa de la Serena;1019;517;502
06;Badajoz;048;Esparragosa de Lares;925;451;474
06;Badajoz;049;Feria;1144;559;585
06;Badajoz;050;Fregenal de la Sierra;4847;2377;2470
06;Badajoz;051;Fuenlabrada de los Montes;1845;908;937
06;Badajoz;052;Fuente de Cantos;4721;2335;2386
06;Badajoz;053;Fuente del Arco;688;353;335
06;Badajoz;054;Fuente del Maestre;6743;3349;3394
06;Badajoz;055;Fuentes de León;2302;1136;1166
06;Badajoz;056;Garbayuela;508;267;241
06;Badajoz;057;Garlitos;587;305;282
06;Badajoz;058;Garrovilla, La;2346;1166;1180
06;Badajoz;059;Granja de Torrehermosa;2014;1001;1013
06;Badajoz;903;Guadiana del Caudillo;2485;1224;1261
06;Badajoz;060;Guareña;6964;3495;3469
06;Badajoz;061;Haba, La;1243;626;617
06;Badajoz;062;Helechosa de los Montes;647;363;284
06;Badajoz;063;Herrera del Duque;3482;1748;1734
06;Badajoz;064;Higuera de la Serena;948;494;454
06;Badajoz;065;Higuera de Llerena;347;178;169
06;Badajoz;066;Higuera de Vargas;1955;982;973
06;Badajoz;067;Higuera la Real;2253;1132;1121
06;Badajoz;068;Hinojosa del Valle;483;231;252
06;Badajoz;069;Hornachos;3595;1807;1788
06;Badajoz;070;Jerez de los Caballeros;9303;4580;4723
06;Badajoz;071;Lapa, La;281;143;138
06;Badajoz;073;Llera;836;426;410
06;Badajoz;074;Llerena;5804;2878;2926
06;Badajoz;072;Lobón;2746;1408;1338
06;Badajoz;075;Magacela;530;272;258
06;Badajoz;076;Maguilla;974;480;494
06;Badajoz;077;Malcocinado;365;198;167
06;Badajoz;078;Malpartida de la Serena;556;290;266
06;Badajoz;079;Manchita;765;385;380
06;Badajoz;080;Medellín;2263;1132;1131
06;Badajoz;081;Medina de las Torres;1184;613;571
06;Badajoz;082;Mengabril;475;260;215
06;Badajoz;083;Mérida;59335;28918;30417
06;Badajoz;084;Mirandilla;1267;641;626
06;Badajoz;085;Monesterio;4226;2165;2061
06;Badajoz;086;Montemolín;1343;646;697
06;Badajoz;087;Monterrubio de la Serena;2372;1168;1204
06;Badajoz;088;Montijo;15457;7640;7817
06;Badajoz;089;Morera, La;715;365;350
06;Badajoz;090;Nava de Santiago, La;932;471;461
06;Badajoz;091;Navalvillar de Pela;4424;2240;2184
06;Badajoz;092;Nogales;652;329;323
06;Badajoz;093;Oliva de la Frontera;5137;2571;2566
06;Badajoz;094;Oliva de Mérida;1729;874;855
06;Badajoz;095;Olivenza;11963;5967;5996
06;Badajoz;096;Orellana de la Sierra;228;113;115
06;Badajoz;097;Orellana la Vieja;2693;1389;1304
06;Badajoz;098;Palomas;678;341;337
06;Badajoz;099;Parra, La;1346;699;647
06;Badajoz;100;Peñalsordo;918;439;479
06;Badajoz;101;Peraleda del Zaucejo;513;259;254
06;Badajoz;102;Puebla de Alcocer;1184;591;593
06;Badajoz;103;Puebla de la Calzada;5845;2917;2928
06;Badajoz;104;Puebla de la Reina;741;370;371
06;Badajoz;107;Puebla de Obando;1836;931;905
06;Badajoz;108;Puebla de Sancho Pérez;2709;1367;1342
06;Badajoz;105;Puebla del Maestre;685;351;334
06;Badajoz;106;Puebla del Prior;490;256;234
06;Badajoz;902;Pueblonuevo del Guadiana;2021;1018;1003
06;Badajoz;109;Quintana de la Serena;4597;2322;2275
06;Badajoz;110;Reina;153;76;77
06;Badajoz;111;Rena;616;316;300
06;Badajoz;112;Retamal de Llerena;443;227;216
06;Badajoz;113;Ribera del Fresno;3348;1662;1686
06;Badajoz;114;Risco;140;70;70
06;Badajoz;115;Roca de la Sierra, La;1464;718;746
06;Badajoz;116;Salvaleón;1755;877;878
06;Badajoz;117;Salvatierra de los Barros;1645;799;846
06;Badajoz;119;San Pedro de Mérida;843;435;408
06;Badajoz;123;San Vicente de Alcántara;5408;2729;2679
06;Badajoz;118;Sancti-Spíritus;167;96;71
06;Badajoz;120;Santa Amalia;4021;2033;1988
06;Badajoz;121;Santa Marta;4122;2078;2044
06;Badajoz;122;Santos de Maimona, Los;8091;4087;4004
06;Badajoz;124;Segura de León;1889;942;947
06;Badajoz;125;Siruela;1903;962;941
06;Badajoz;126;Solana de los Barros;2623;1308;1315
06;Badajoz;127;Talarrubias;3412;1700;1712
06;Badajoz;128;Talavera la Real;5314;2651;2663
06;Badajoz;129;Táliga;665;334;331
06;Badajoz;130;Tamurejo;214;113;101
06;Badajoz;131;Torre de Miguel Sesmero;1250;641;609
06;Badajoz;132;Torremayor;957;465;492
06;Badajoz;133;Torremejía;2250;1163;1087
06;Badajoz;134;Trasierra;622;328;294
06;Badajoz;135;Trujillanos;1387;710;677
06;Badajoz;136;Usagre;1763;873;890
06;Badajoz;137;Valdecaballeros;1077;558;519
06;Badajoz;901;Valdelacalzada;2711;1384;1327
06;Badajoz;138;Valdetorres;1173;573;600
06;Badajoz;139;Valencia de las Torres;564;296;268
06;Badajoz;140;Valencia del Mombuey;744;379;365
06;Badajoz;141;Valencia del Ventoso;1973;975;998
06;Badajoz;146;Valle de la Serena;1191;600;591
06;Badajoz;147;Valle de Matamoros;367;179;188
06;Badajoz;148;Valle de Santa Ana;1139;559;580
06;Badajoz;142;Valverde de Burguillos;273;145;128
06;Badajoz;143;Valverde de Leganés;4159;2093;2066
06;Badajoz;144;Valverde de Llerena;585;293;292
06;Badajoz;145;Valverde de Mérida;1055;535;520
06;Badajoz;149;Villafranca de los Barros;12835;6311;6524
06;Badajoz;150;Villagarcía de la Torre;907;468;439
06;Badajoz;151;Villagonzalo;1234;601;633
06;Badajoz;152;Villalba de los Barros;1477;746;731
06;Badajoz;153;Villanueva de la Serena;25667;12486;13181
06;Badajoz;154;Villanueva del Fresno;3397;1697;1700
06;Badajoz;156;Villar de Rena;1379;709;670
06;Badajoz;155;Villar del Rey;2117;1125;992
06;Badajoz;157;Villarta de los Montes;437;221;216
06;Badajoz;158;Zafra;16797;8094;8703
06;Badajoz;159;Zahínos;2803;1391;1412
06;Badajoz;160;Zalamea de la Serena;3555;1788;1767
06;Badajoz;162;Zarza, La;3472;1749;1723
06;Badajoz;161;Zarza-Capilla;311;155;156
07;Balears, Illes;002;Alaior;9065;4576;4489
07;Balears, Illes;001;Alaró;5572;2689;2883
07;Balears, Illes;003;Alcúdia;20241;10252;9989
07;Balears, Illes;004;Algaida;5642;2882;2760
07;Balears, Illes;005;Andratx;11271;5625;5646
07;Balears, Illes;901;Ariany;868;453;415
07;Balears, Illes;006;Artà;7845;3949;3896
07;Balears, Illes;007;Banyalbufar;515;272;243
07;Balears, Illes;008;Binissalem;8567;4246;4321
07;Balears, Illes;009;Búger;1050;551;499
07;Balears, Illes;010;Bunyola;6809;3333;3476
07;Balears, Illes;011;Calvià;50559;25395;25164
07;Balears, Illes;012;Campanet;2640;1352;1288
07;Balears, Illes;013;Campos;10862;5433;5429
07;Balears, Illes;014;Capdepera;11868;6059;5809
07;Balears, Illes;064;Castell, Es;7434;3785;3649
07;Balears, Illes;015;Ciutadella de Menorca;29840;14802;15038
07;Balears, Illes;016;Consell;4053;2024;2029
07;Balears, Illes;017;Costitx;1288;638;650
07;Balears, Illes;018;Deià;617;299;318
07;Balears, Illes;026;Eivissa;49783;25031;24752
07;Balears, Illes;019;Escorca;212;129;83
07;Balears, Illes;020;Esporles;5062;2503;2559
07;Balears, Illes;021;Estellencs;315;174;141
07;Balears, Illes;022;Felanitx;17780;8956;8824
07;Balears, Illes;023;Ferreries;4777;2384;2393
07;Balears, Illes;024;Formentera;12111;6365;5746
07;Balears, Illes;025;Fornalutx;660;330;330
07;Balears, Illes;027;Inca;33319;16831;16488
07;Balears, Illes;028;Lloret de Vistalegre;1372;694;678
07;Balears, Illes;029;Lloseta;5988;3009;2979
07;Balears, Illes;030;Llubí;2273;1140;1133
07;Balears, Illes;031;Llucmajor;36914;18702;18212
07;Balears, Illes;033;Manacor;43808;21927;21881
07;Balears, Illes;034;Mancor de la Vall;1509;763;746
07;Balears, Illes;032;Maó-Mahón;29040;14147;14893
07;Balears, Illes;035;Maria de la Salut;2227;1156;1071
07;Balears, Illes;036;Marratxí;37193;18735;18458
07;Balears, Illes;037;Mercadal, Es;5038;2542;2496
07;Balears, Illes;902;Migjorn Gran, Es;1405;696;709
07;Balears, Illes;038;Montuïri;2912;1465;1447
07;Balears, Illes;039;Muro;7085;3574;3511
07;Balears, Illes;040;Palma ;416065;203195;212870
07;Balears, Illes;041;Petra;2860;1419;1441
07;Balears, Illes;044;Pobla, Sa;13475;6845;6630
07;Balears, Illes;042;Pollença;16283;8088;8195
07;Balears, Illes;043;Porreres;5502;2823;2679
07;Balears, Illes;045;Puigpunyent;2012;997;1015
07;Balears, Illes;059;Salines, Ses;4960;2525;2435
07;Balears, Illes;046;Sant Antoni de Portmany;26306;13788;12518
07;Balears, Illes;049;Sant Joan;2108;1039;1069
07;Balears, Illes;050;Sant Joan de Labritja;6397;3282;3115
07;Balears, Illes;048;Sant Josep de sa Talaia;27413;14114;13299
07;Balears, Illes;051;Sant Llorenç des Cardassar;8431;4167;4264
07;Balears, Illes;052;Sant Lluís;6798;3458;3340
07;Balears, Illes;053;Santa Eugènia;1561;769;792
07;Balears, Illes;054;Santa Eulària des Riu;38015;19254;18761
07;Balears, Illes;055;Santa Margalida;12485;6391;6094
07;Balears, Illes;056;Santa María del Camí;7375;3664;3711
07;Balears, Illes;057;Santanyí;12237;6163;6074
07;Balears, Illes;058;Selva;4014;1991;2023
07;Balears, Illes;047;Sencelles;3290;1654;1636
07;Balears, Illes;060;Sineu;3862;1913;1949
07;Balears, Illes;061;Sóller;13705;6850;6855
07;Balears, Illes;062;Son Servera;11568;5776;5792
07;Balears, Illes;063;Valldemossa;1969;991;978
07;Balears, Illes;065;Vilafranca de Bonany;3380;1733;1647
08;Barcelona;001;Abrera;12489;6326;6163
08;Barcelona;002;Aguilar de Segarra;288;155;133
08;Barcelona;014;Aiguafreda;2504;1208;1296
08;Barcelona;003;Alella;9801;4762;5039
08;Barcelona;004;Alpens;266;144;122
08;Barcelona;005;Ametlla del Vallès, L';8462;4277;4185
08;Barcelona;006;Arenys de Mar;15776;7683;8093
08;Barcelona;007;Arenys de Munt;8931;4483;4448
08;Barcelona;008;Argençola;217;110;107
08;Barcelona;009;Argentona;12452;6132;6320
08;Barcelona;010;Artés;5698;2868;2830
08;Barcelona;011;Avià;2226;1121;1105
08;Barcelona;012;Avinyó;2275;1127;1148
08;Barcelona;013;Avinyonet del Penedès;1701;903;798
08;Barcelona;015;Badalona;220440;108509;111931
08;Barcelona;904;Badia del Vallès;13380;6567;6813
08;Barcelona;016;Bagà;2138;1064;1074
08;Barcelona;017;Balenyà;3821;1928;1893
08;Barcelona;018;Balsareny;3159;1562;1597
08;Barcelona;252;Barberà del Vallès;33091;16300;16791
08;Barcelona;019;Barcelona;1636762;775619;861143
08;Barcelona;020;Begues;7098;3528;3570
08;Barcelona;021;Bellprat;64;41;23
08;Barcelona;022;Berga;16494;8166;8328
08;Barcelona;023;Bigues i Riells;9092;4645;4447
08;Barcelona;024;Borredà;445;253;192
08;Barcelona;025;Bruc, El;2050;1107;943
08;Barcelona;026;Brull, El;263;145;118
08;Barcelona;027;Cabanyes, Les;964;488;476
08;Barcelona;028;Cabrera d'Anoia;1410;769;641
08;Barcelona;029;Cabrera de Mar;4680;2348;2332
08;Barcelona;030;Cabrils;7439;3682;3757
08;Barcelona;031;Calaf;3535;1775;1760
08;Barcelona;034;Calders;970;499;471
08;Barcelona;033;Caldes de Montbui;17554;8745;8809
08;Barcelona;032;Caldes d'Estrac;2982;1426;1556
08;Barcelona;035;Calella;19069;9339;9730
08;Barcelona;037;Calldetenes;2489;1259;1230
08;Barcelona;038;Callús;2140;1061;1079
08;Barcelona;036;Calonge de Segarra;188;92;96
08;Barcelona;039;Campins;529;277;252
08;Barcelona;040;Canet de Mar;14526;7068;7458
08;Barcelona;041;Canovelles;16629;8613;8016
08;Barcelona;042;Cànoves i Samalús;3117;1581;1536
08;Barcelona;043;Canyelles;4647;2414;2233
08;Barcelona;044;Capellades;5293;2636;2657
08;Barcelona;045;Capolat;94;44;50
08;Barcelona;046;Cardedeu;18357;8957;9400
08;Barcelona;047;Cardona;4636;2273;2363
08;Barcelona;048;Carme;765;396;369
08;Barcelona;049;Casserres;1608;813;795
08;Barcelona;057;Castell de l'Areny;68;38;30
08;Barcelona;052;Castellar de n'Hug;159;85;74
08;Barcelona;050;Castellar del Riu;169;94;75
08;Barcelona;051;Castellar del Vallès;24187;11948;12239
08;Barcelona;053;Castellbell i el Vilar;3647;1863;1784
08;Barcelona;054;Castellbisbal;12390;6238;6152
08;Barcelona;055;Castellcir;752;392;360
08;Barcelona;056;Castelldefels;67004;33018;33986
08;Barcelona;058;Castellet i la Gornal;2292;1180;1112
08;Barcelona;060;Castellfollit de Riubregós;151;86;65
08;Barcelona;059;Castellfollit del Boix;436;222;214
08;Barcelona;061;Castellgalí;2062;1062;1000
08;Barcelona;062;Castellnou de Bages;1397;732;665
08;Barcelona;063;Castellolí;619;302;317
08;Barcelona;064;Castellterçol;2463;1236;1227
08;Barcelona;065;Castellví de la Marca;1535;771;764
08;Barcelona;066;Castellví de Rosanes;1884;931;953
08;Barcelona;067;Centelles;7404;3630;3774
08;Barcelona;268;Cercs;1145;577;568
08;Barcelona;266;Cerdanyola del Vallès;57403;28038;29365
08;Barcelona;068;Cervelló;9054;4529;4525
08;Barcelona;069;Collbató;4466;2320;2146
08;Barcelona;070;Collsuspina;342;174;168
08;Barcelona;071;Copons;310;152;158
08;Barcelona;072;Corbera de Llobregat;14822;7449;7373
08;Barcelona;073;Cornellà de Llobregat;88592;42945;45647
08;Barcelona;074;Cubelles;15329;7687;7642
08;Barcelona;075;Dosrius;5481;2780;2701
08;Barcelona;076;Esparreguera;22251;11249;11002
08;Barcelona;077;Esplugues de Llobregat;46680;22300;24380
08;Barcelona;078;Espunyola, L';254;126;128
08;Barcelona;254;Esquirol, L';2181;1105;1076
08;Barcelona;079;Estany, L';406;205;201
08;Barcelona;134;Figaró-Montmany;1114;547;567
08;Barcelona;080;Fígols;42;25;17
08;Barcelona;082;Fogars de la Selva;1451;748;703
08;Barcelona;081;Fogars de Montclús;470;245;225
08;Barcelona;083;Folgueroles;2267;1159;1108
08;Barcelona;084;Fonollosa;1453;750;703
08;Barcelona;085;Font-rubí;1327;688;639
08;Barcelona;086;Franqueses del Vallès, Les;20092;10210;9882
08;Barcelona;090;Gaià;175;97;78
08;Barcelona;087;Gallifa;172;95;77
08;Barcelona;088;Garriga, La;16514;7987;8527
08;Barcelona;089;Gavà;46771;22876;23895
08;Barcelona;091;Gelida;7533;3778;3755
08;Barcelona;092;Gironella;4826;2384;2442
08;Barcelona;093;Gisclareny;25;15;10
08;Barcelona;094;Granada, La;2157;1092;1065
08;Barcelona;095;Granera;69;53;16
08;Barcelona;096;Granollers;61275;30199;31076
08;Barcelona;097;Gualba;1500;769;731
08;Barcelona;099;Guardiola de Berguedà;908;464;444
08;Barcelona;100;Gurb;2681;1386;1295
08;Barcelona;101;Hospitalet de Llobregat, L';264923;127981;136942
08;Barcelona;162;Hostalets de Pierola, Els;2973;1518;1455
08;Barcelona;102;Igualada;39967;19636;20331
08;Barcelona;103;Jorba;835;424;411
08;Barcelona;104;Llacuna, La;870;475;395
08;Barcelona;105;Llagosta, La;13480;6675;6805
08;Barcelona;107;Lliçà d'Amunt;15256;7819;7437
08;Barcelona;108;Lliçà de Vall;6542;3335;3207
08;Barcelona;106;Llinars del Vallès;9938;4946;4992
08;Barcelona;109;Lluçà;273;134;139
08;Barcelona;110;Malgrat de Mar;18579;9280;9299
08;Barcelona;111;Malla;273;139;134
08;Barcelona;112;Manlleu;20573;10314;10259
08;Barcelona;113;Manresa;77714;38066;39648
08;Barcelona;242;Marganell;266;131;135
08;Barcelona;114;Martorell;28189;14329;13860
08;Barcelona;115;Martorelles;4801;2422;2379
08;Barcelona;116;Masies de Roda, Les;700;355;345
08;Barcelona;117;Masies de Voltregà, Les;3141;1551;1590
08;Barcelona;118;Masnou, El;23515;11357;12158
08;Barcelona;119;Masquefa;9211;4641;4570
08;Barcelona;120;Matadepera;9326;4657;4669
08;Barcelona;121;Mataró;128265;63637;64628
08;Barcelona;122;Mediona;2322;1159;1163
08;Barcelona;138;Moià;6267;3190;3077
08;Barcelona;123;Molins de Rei;25868;12612;13256
08;Barcelona;124;Mollet del Vallès;51318;25222;26096
08;Barcelona;128;Monistrol de Calders;682;357;325
08;Barcelona;127;Monistrol de Montserrat;3034;1551;1483
08;Barcelona;125;Montcada i Reixac;36239;17901;18338
08;Barcelona;130;Montclar;136;71;65
08;Barcelona;131;Montesquiu;998;501;497
08;Barcelona;126;Montgat;12041;5938;6103
08;Barcelona;132;Montmajor;464;231;233
08;Barcelona;133;Montmaneu;150;83;67
08;Barcelona;135;Montmeló;8755;4275;4480
08;Barcelona;136;Montornès del Vallès;16393;8251;8142
08;Barcelona;137;Montseny;342;179;163
08;Barcelona;129;Muntanyola;634;321;313
08;Barcelona;139;Mura;224;122;102
08;Barcelona;140;Navarcles;5977;2914;3063
08;Barcelona;141;Navàs;6020;2998;3022
08;Barcelona;142;Nou de Berguedà, La;161;83;78
08;Barcelona;143;Òdena;3643;1848;1795
08;Barcelona;145;Olèrdola;3692;1900;1792
08;Barcelona;146;Olesa de Bonesvalls;1810;949;861
08;Barcelona;147;Olesa de Montserrat;23904;11913;11991
08;Barcelona;148;Olivella;3799;1985;1814
08;Barcelona;149;Olost;1198;588;610
08;Barcelona;144;Olvan;854;416;438
08;Barcelona;150;Orís;315;159;156
08;Barcelona;151;Oristà;541;274;267
08;Barcelona;152;Orpí;147;80;67
08;Barcelona;153;Òrrius;739;381;358
08;Barcelona;154;Pacs del Penedès;922;469;453
08;Barcelona;155;Palafolls;9405;4690;4715
08;Barcelona;156;Palau-solità i Plegamans;14771;7246;7525
08;Barcelona;157;Pallejà;11508;5728;5780
08;Barcelona;905;Palma de Cervelló, La;2954;1460;1494
08;Barcelona;158;Papiol, El;4145;2052;2093
08;Barcelona;159;Parets del Vallès;19082;9541;9541
08;Barcelona;160;Perafita;395;202;193
08;Barcelona;161;Piera;15603;7976;7627
08;Barcelona;163;Pineda de Mar;27272;13588;13684
08;Barcelona;164;Pla del Penedès, El;1256;636;620
08;Barcelona;165;Pobla de Claramunt, La;2193;1104;1089
08;Barcelona;166;Pobla de Lillet, La;1095;528;567
08;Barcelona;167;Polinyà;8479;4295;4184
08;Barcelona;182;Pont de Vilomara i Rocafort, El;3830;1969;1861
08;Barcelona;168;Pontons;532;289;243
08;Barcelona;169;Prat de Llobregat, El;64599;31621;32978
08;Barcelona;171;Prats de Lluçanès;2569;1280;1289
08;Barcelona;170;Prats de Rei, Els;532;283;249
08;Barcelona;230;Premià de Dalt;10448;5207;5241
08;Barcelona;172;Premià de Mar;28119;13704;14415
08;Barcelona;174;Puigdàlber;526;256;270
08;Barcelona;175;Puig-reig;4178;2086;2092
08;Barcelona;176;Pujalt;210;119;91
08;Barcelona;177;Quar, La;53;29;24
08;Barcelona;178;Rajadell;548;275;273
08;Barcelona;179;Rellinars;780;403;377
08;Barcelona;180;Ripollet;38665;19080;19585
08;Barcelona;181;Roca del Vallès, La;10650;5319;5331
08;Barcelona;183;Roda de Ter;6301;3118;3183
08;Barcelona;184;Rubí;77464;38358;39106
08;Barcelona;185;Rubió;239;133;106
08;Barcelona;901;Rupit i Pruit;279;139;140
08;Barcelona;187;Sabadell;213644;103847;109797
08;Barcelona;188;Sagàs;148;80;68
08;Barcelona;190;Saldes;274;159;115
08;Barcelona;191;Sallent;6658;3211;3447
08;Barcelona;194;Sant Adrià de Besòs;37097;18251;18846
08;Barcelona;195;Sant Agustí de Lluçanès;85;42;43
08;Barcelona;196;Sant Andreu de la Barca;27558;13679;13879
08;Barcelona;197;Sant Andreu de Llavaneres;10968;5424;5544
08;Barcelona;198;Sant Antoni de Vilamajor;6135;3031;3104
08;Barcelona;199;Sant Bartomeu del Grau;858;460;398
08;Barcelona;200;Sant Boi de Llobregat;83605;40877;42728
08;Barcelona;201;Sant Boi de Lluçanès;541;269;272
08;Barcelona;203;Sant Cebrià de Vallalta;3385;1764;1621
08;Barcelona;202;Sant Celoni;17904;8939;8965
08;Barcelona;204;Sant Climent de Llobregat;4129;2075;2054
08;Barcelona;205;Sant Cugat del Vallès;91006;44197;46809
08;Barcelona;206;Sant Cugat Sesgarrigues;1007;488;519
08;Barcelona;207;Sant Esteve de Palautordera;2820;1391;1429
08;Barcelona;208;Sant Esteve Sesrovires;7612;3835;3777
08;Barcelona;210;Sant Feliu de Codines;6259;3168;3091
08;Barcelona;211;Sant Feliu de Llobregat;44860;21767;23093
08;Barcelona;212;Sant Feliu Sasserra;602;312;290
08;Barcelona;209;Sant Fost de Campsentelles;8737;4352;4385
08;Barcelona;213;Sant Fruitós de Bages;8703;4295;4408
08;Barcelona;215;Sant Hipòlit de Voltregà;3484;1729;1755
08;Barcelona;193;Sant Iscle de Vallalta;1332;687;645
08;Barcelona;216;Sant Jaume de Frontanyà;30;18;12
08;Barcelona;218;Sant Joan de Vilatorrada;10936;5490;5446
08;Barcelona;217;Sant Joan Despí;34123;16585;17538
08;Barcelona;903;Sant Julià de Cerdanyola;228;125;103
08;Barcelona;220;Sant Julià de Vilatorta;3114;1539;1575
08;Barcelona;221;Sant Just Desvern;17805;8544;9261
08;Barcelona;222;Sant Llorenç d'Hortons;2413;1226;1187
08;Barcelona;223;Sant Llorenç Savall;2373;1197;1176
08;Barcelona;225;Sant Martí d'Albars;112;56;56
08;Barcelona;224;Sant Martí de Centelles;1167;600;567
08;Barcelona;226;Sant Martí de Tous;1235;637;598
08;Barcelona;227;Sant Martí Sarroca;3264;1608;1656
08;Barcelona;228;Sant Martí Sesgueioles;343;176;167
08;Barcelona;229;Sant Mateu de Bages;603;302;301
08;Barcelona;231;Sant Pere de Ribes;30719;15268;15451
08;Barcelona;232;Sant Pere de Riudebitlles;2368;1181;1187
08;Barcelona;233;Sant Pere de Torelló;2419;1242;1177
08;Barcelona;234;Sant Pere de Vilamajor;4472;2239;2233
08;Barcelona;189;Sant Pere Sallavinera;152;82;70
08;Barcelona;235;Sant Pol de Mar;5299;2604;2695
08;Barcelona;236;Sant Quintí de Mediona;2254;1154;1100
08;Barcelona;237;Sant Quirze de Besora;2167;1054;1113
08;Barcelona;238;Sant Quirze del Vallès;20141;9865;10276
08;Barcelona;239;Sant Quirze Safaja;627;336;291
08;Barcelona;240;Sant Sadurní d'Anoia;12887;6348;6539
08;Barcelona;241;Sant Sadurní d'Osormort;78;47;31
08;Barcelona;098;Sant Salvador de Guardiola;3179;1630;1549
08;Barcelona;262;Sant Vicenç de Castellet;9523;4760;4763
08;Barcelona;264;Sant Vicenç de Montalt;6407;3199;3208
08;Barcelona;265;Sant Vicenç de Torelló;2058;1019;1039
08;Barcelona;263;Sant Vicenç dels Horts;28117;13959;14158
08;Barcelona;243;Santa Cecília de Voltregà;187;99;88
08;Barcelona;244;Santa Coloma de Cervelló;8218;4026;4192
08;Barcelona;245;Santa Coloma de Gramenet;119215;58895;60320
08;Barcelona;246;Santa Eugènia de Berga;2248;1142;1106
08;Barcelona;247;Santa Eulàlia de Riuprimer;1345;686;659
08;Barcelona;248;Santa Eulàlia de Ronçana;7288;3639;3649
08;Barcelona;249;Santa Fe del Penedès;374;185;189
08;Barcelona;250;Santa Margarida de Montbui;9980;4993;4987
08;Barcelona;251;Santa Margarida i els Monjos;7611;3856;3755
08;Barcelona;253;Santa Maria de Besora;150;78;72
08;Barcelona;256;Santa Maria de Martorelles;893;449;444
08;Barcelona;255;Santa Maria de Merlès;184;89;95
08;Barcelona;257;Santa Maria de Miralles;126;68;58
08;Barcelona;259;Santa Maria de Palautordera;9423;4760;4663
08;Barcelona;258;Santa Maria d'Oló;1025;521;504
08;Barcelona;260;Santa Perpètua de Mogoda;25799;12958;12841
08;Barcelona;261;Santa Susanna;3446;1721;1725
08;Barcelona;192;Santpedor;7554;3755;3799
08;Barcelona;267;Sentmenat;9078;4611;4467
08;Barcelona;269;Seva;3519;1784;1735
08;Barcelona;270;Sitges;29307;14708;14599
08;Barcelona;271;Sobremunt;79;36;43
08;Barcelona;272;Sora;209;117;92
08;Barcelona;273;Subirats;3044;1577;1467
08;Barcelona;274;Súria;5942;2897;3045
08;Barcelona;276;Tagamanent;323;169;154
08;Barcelona;277;Talamanca;206;115;91
08;Barcelona;278;Taradell;6489;3238;3251
08;Barcelona;275;Tavèrnoles;316;159;157
08;Barcelona;280;Tavertet;111;57;54
08;Barcelona;281;Teià;6397;3134;3263
08;Barcelona;279;Terrassa;220556;108469;112087
08;Barcelona;282;Tiana;8840;4233;4607
08;Barcelona;283;Tona;8241;4099;4142
08;Barcelona;284;Tordera;17216;8722;8494
08;Barcelona;285;Torelló;14347;7137;7210
08;Barcelona;286;Torre de Claramunt, La;3714;1923;1791
08;Barcelona;287;Torrelavit;1419;723;696
08;Barcelona;288;Torrelles de Foix;2348;1267;1081
08;Barcelona;289;Torrelles de Llobregat;6041;3003;3038
08;Barcelona;290;Ullastrell;2093;1052;1041
08;Barcelona;291;Vacarisses;6688;3436;3252
08;Barcelona;292;Vallbona d'Anoia;1373;719;654
08;Barcelona;293;Vallcebre;250;142;108
08;Barcelona;294;Vallgorguina;2891;1451;1440
08;Barcelona;295;Vallirana;15006;7523;7483
08;Barcelona;296;Vallromanes;2579;1328;1251
08;Barcelona;297;Veciana;182;99;83
08;Barcelona;298;Vic;46214;23306;22908
08;Barcelona;299;Vilada;416;217;199
08;Barcelona;301;Viladecans;66611;32930;33681
08;Barcelona;300;Viladecavalls;7512;3724;3788
08;Barcelona;305;Vilafranca del Penedès;39746;19341;20405
08;Barcelona;306;Vilalba Sasserra;716;357;359
08;Barcelona;303;Vilanova de Sau;299;142;157
08;Barcelona;302;Vilanova del Camí;12458;6227;6231
08;Barcelona;902;Vilanova del Vallès;5432;2760;2672
08;Barcelona;307;Vilanova i la Geltrú;67086;32456;34630
08;Barcelona;214;Vilassar de Dalt;9043;4462;4581
08;Barcelona;219;Vilassar de Mar;20837;10068;10769
08;Barcelona;304;Vilobí del Penedès;1107;569;538
08;Barcelona;308;Viver i Serrateix;168;87;81
48;Bizkaia;001;Abadiño;7599;3815;3784
48;Bizkaia;002;Abanto y Ciérvana-Abanto Zierbena;9444;4668;4776
48;Bizkaia;911;Ajangiz;477;249;228
48;Bizkaia;912;Alonsotegi;2907;1427;1480
48;Bizkaia;003;Amorebieta-Etxano;19339;9531;9808
48;Bizkaia;004;Amoroto;410;208;202
48;Bizkaia;005;Arakaldo;159;79;80
48;Bizkaia;006;Arantzazu;395;191;204
48;Bizkaia;093;Areatza;1201;578;623
48;Bizkaia;009;Arrankudiaga;968;479;489
48;Bizkaia;914;Arratzu;418;203;215
48;Bizkaia;010;Arrieta;586;300;286
48;Bizkaia;011;Arrigorriaga;12160;5923;6237
48;Bizkaia;023;Artea;736;366;370
48;Bizkaia;008;Artzentales;721;385;336
48;Bizkaia;091;Atxondo;1366;685;681
48;Bizkaia;070;Aulesti;654;323;331
48;Bizkaia;012;Bakio;2688;1357;1331
48;Bizkaia;090;Balmaseda;7697;3717;3980
48;Bizkaia;013;Barakaldo;100881;48681;52200
48;Bizkaia;014;Barrika;1529;747;782
48;Bizkaia;015;Basauri;40589;19639;20950
48;Bizkaia;092;Bedia;1067;508;559
48;Bizkaia;016;Berango;7195;3530;3665
48;Bizkaia;017;Bermeo;16765;8254;8511
48;Bizkaia;018;Berriatua;1245;686;559
48;Bizkaia;019;Berriz;4623;2295;2328
48;Bizkaia;020;Bilbao;346843;163563;183280
48;Bizkaia;021;Busturia;1616;807;809
48;Bizkaia;901;Derio;6631;3256;3375
48;Bizkaia;026;Dima;1436;741;695
48;Bizkaia;027;Durango;29791;14554;15237
48;Bizkaia;028;Ea;823;431;392
48;Bizkaia;031;Elantxobe;350;176;174
48;Bizkaia;032;Elorrio;7372;3634;3738
48;Bizkaia;902;Erandio;24350;11808;12542
48;Bizkaia;033;Ereño;245;140;105
48;Bizkaia;034;Ermua;15880;7909;7971
48;Bizkaia;079;Errigoiti;479;263;216
48;Bizkaia;029;Etxebarri;11563;5792;5771
48;Bizkaia;030;Etxebarria;788;394;394
48;Bizkaia;906;Forua;920;449;471
48;Bizkaia;035;Fruiz;536;272;264
48;Bizkaia;036;Galdakao;29326;14454;14872
48;Bizkaia;037;Galdames;831;442;389
48;Bizkaia;038;Gamiz-Fika;1379;678;701
48;Bizkaia;039;Garai;327;163;164
48;Bizkaia;040;Gatika;1663;837;826
48;Bizkaia;041;Gautegiz Arteaga;836;421;415
48;Bizkaia;046;Gernika-Lumo;17016;8171;8845
48;Bizkaia;044;Getxo;77946;36461;41485
48;Bizkaia;047;Gizaburuaga;208;105;103
48;Bizkaia;042;Gordexola;1710;875;835
48;Bizkaia;043;Gorliz;5785;2849;2936
48;Bizkaia;045;Güeñes;6734;3254;3480
48;Bizkaia;048;Ibarrangelu;632;321;311
48;Bizkaia;094;Igorre;4284;2107;2177
48;Bizkaia;049;Ispaster;735;389;346
48;Bizkaia;910;Iurreta;3662;1810;1852
48;Bizkaia;050;Izurtza;255;159;96
48;Bizkaia;022;Karrantza Harana/Valle de Carranza;2778;1437;1341
48;Bizkaia;907;Kortezubi;441;220;221
48;Bizkaia;051;Lanestosa;251;136;115
48;Bizkaia;052;Larrabetzu;2033;981;1052
48;Bizkaia;053;Laukiz;1194;598;596
48;Bizkaia;054;Leioa;31795;15498;16297
48;Bizkaia;057;Lekeitio;7307;3609;3698
48;Bizkaia;055;Lemoa;3486;1741;1745
48;Bizkaia;056;Lemoiz;1238;654;584
48;Bizkaia;081;Lezama;2412;1197;1215
48;Bizkaia;903;Loiu;2433;1239;1194
48;Bizkaia;058;Mallabia;1158;592;566
48;Bizkaia;059;Mañaria;515;263;252
48;Bizkaia;060;Markina-Xemein;5006;2542;2464
48;Bizkaia;061;Maruri-Jatabe;991;511;480
48;Bizkaia;062;Mendata;383;197;186
48;Bizkaia;063;Mendexa;438;220;218
48;Bizkaia;064;Meñaka;761;396;365
48;Bizkaia;066;Morga;410;219;191
48;Bizkaia;068;Mundaka;1852;898;954
48;Bizkaia;069;Mungia;17691;8618;9073
48;Bizkaia;007;Munitibar-Arbatzegi Gerrikaitz;468;257;211
48;Bizkaia;908;Murueta;308;155;153
48;Bizkaia;071;Muskiz;7507;3691;3816
48;Bizkaia;067;Muxika;1465;761;704
48;Bizkaia;909;Nabarniz;253;126;127
48;Bizkaia;073;Ondarroa;8400;4209;4191
48;Bizkaia;075;Orozko;2636;1294;1342
48;Bizkaia;083;Ortuella;8395;4091;4304
48;Bizkaia;072;Otxandio;1314;670;644
48;Bizkaia;077;Plentzia;4331;2114;2217
48;Bizkaia;078;Portugalete;45766;21884;23882
48;Bizkaia;082;Santurtzi;45853;22023;23830
48;Bizkaia;084;Sestao;27296;13195;14101
48;Bizkaia;904;Sondika;4502;2173;2329
48;Bizkaia;085;Sopela;13878;6844;7034
48;Bizkaia;086;Sopuerta;2527;1247;1280
48;Bizkaia;076;Sukarrieta;332;169;163
48;Bizkaia;087;Trucios-Turtzioz;501;265;236
48;Bizkaia;088;Ubide;160;83;77
48;Bizkaia;065;Ugao-Miraballes;4152;2101;2051
48;Bizkaia;089;Urduliz;4456;2236;2220
48;Bizkaia;074;Urduña/Orduña;4232;2195;2037
48;Bizkaia;080;Valle de Trápaga-Trapagaran;11985;5826;6159
48;Bizkaia;095;Zaldibar;3043;1526;1517
48;Bizkaia;096;Zalla;8447;4189;4258
48;Bizkaia;905;Zamudio;3260;1608;1652
48;Bizkaia;097;Zaratamo;1614;805;809
48;Bizkaia;024;Zeanuri;1250;639;611
48;Bizkaia;025;Zeberio;1073;557;516
48;Bizkaia;913;Zierbena;1490;785;705
48;Bizkaia;915;Ziortza-Bolibar;413;219;194
09;Burgos;001;Abajas;31;21;10
09;Burgos;003;Adrada de Haza;203;101;102
09;Burgos;006;Aguas Cándidas;56;35;21
09;Burgos;007;Aguilar de Bureba;58;38;20
09;Burgos;009;Albillos;209;109;100
09;Burgos;010;Alcocero de Mola;32;23;9
09;Burgos;011;Alfoz de Bricia;76;47;29
09;Burgos;907;Alfoz de Quintanadueñas;2114;1123;991
09;Burgos;012;Alfoz de Santa Gadea;101;58;43
09;Burgos;013;Altable;51;31;20
09;Burgos;014;Altos, Los;195;111;84
09;Burgos;016;Ameyugo;107;55;52
09;Burgos;017;Anguix;136;77;59
09;Burgos;018;Aranda de Duero;32856;15941;16915
09;Burgos;019;Arandilla;160;101;59
09;Burgos;020;Arauzo de Miel;306;168;138
09;Burgos;021;Arauzo de Salce;58;35;23
09;Burgos;022;Arauzo de Torre;71;43;28
09;Burgos;023;Arcos;1734;911;823
09;Burgos;024;Arenillas de Riopisuerga;180;104;76
09;Burgos;025;Arija;129;68;61
09;Burgos;026;Arlanzón;400;243;157
09;Burgos;027;Arraya de Oca;49;29;20
09;Burgos;029;Atapuerca;162;91;71
09;Burgos;030;Ausines, Los;133;80;53
09;Burgos;032;Avellanosa de Muñó;108;60;48
09;Burgos;033;Bahabón de Esgueva;81;45;36
09;Burgos;034;Balbases, Los;324;177;147
09;Burgos;035;Baños de Valdearados;324;192;132
09;Burgos;036;Bañuelos de Bureba;37;22;15
09;Burgos;037;Barbadillo de Herreros;107;67;40
09;Burgos;038;Barbadillo del Mercado;142;78;64
09;Burgos;039;Barbadillo del Pez;68;40;28
09;Burgos;041;Barrio de Muñó;33;19;14
09;Burgos;043;Barrios de Bureba, Los;198;113;85
09;Burgos;044;Barrios de Colina;56;31;25
09;Burgos;045;Basconcillos del Tozo;293;164;129
09;Burgos;046;Bascuñana;24;16;8
09;Burgos;047;Belbimbre;61;34;27
09;Burgos;048;Belorado;1781;914;867
09;Burgos;050;Berberana;54;31;23
09;Burgos;051;Berlangas de Roa;184;100;84
09;Burgos;052;Berzosa de Bureba;29;22;7
09;Burgos;054;Bozoó;95;58;37
09;Burgos;055;Brazacorta;56;32;24
09;Burgos;056;Briviesca;6595;3290;3305
09;Burgos;057;Bugedo;186;120;66
09;Burgos;058;Buniel;546;300;246
09;Burgos;059;Burgos;175821;83713;92108
09;Burgos;060;Busto de Bureba;139;74;65
09;Burgos;061;Cabañes de Esgueva;164;94;70
09;Burgos;062;Cabezón de la Sierra;40;17;23
09;Burgos;064;Caleruega;423;215;208
09;Burgos;065;Campillo de Aranda;182;110;72
09;Burgos;066;Campolara;57;41;16
09;Burgos;067;Canicosa de la Sierra;449;237;212
09;Burgos;068;Cantabrana;25;15;10
09;Burgos;070;Carazo;33;23;10
09;Burgos;071;Carcedo de Bureba;42;23;19
09;Burgos;072;Carcedo de Burgos;399;212;187
09;Burgos;073;Cardeñadijo;1341;735;606
09;Burgos;074;Cardeñajimeno;1105;570;535
09;Burgos;075;Cardeñuela Riopico;115;67;48
09;Burgos;076;Carrias;26;20;6
09;Burgos;077;Cascajares de Bureba;32;14;18
09;Burgos;078;Cascajares de la Sierra;37;20;17
09;Burgos;079;Castellanos de Castro;51;31;20
09;Burgos;083;Castil de Peones;27;14;13
09;Burgos;082;Castildelgado;36;21;15
09;Burgos;084;Castrillo de la Reina;177;114;63
09;Burgos;085;Castrillo de la Vega;621;340;281
09;Burgos;088;Castrillo de Riopisuerga;61;37;24
09;Burgos;086;Castrillo del Val;796;456;340
09;Burgos;090;Castrillo Mota de Judíos;51;27;24
09;Burgos;091;Castrojeriz;796;417;379
09;Burgos;063;Cavia;242;141;101
09;Burgos;093;Cayuela;184;99;85
09;Burgos;094;Cebrecos;53;33;20
09;Burgos;095;Celada del Camino;123;59;64
09;Burgos;098;Cerezo de Río Tirón;555;304;251
09;Burgos;100;Cerratón de Juarros;62;40;22
09;Burgos;101;Ciadoncha;75;44;31
09;Burgos;102;Cillaperlata;32;22;10
09;Burgos;103;Cilleruelo de Abajo;218;123;95
09;Burgos;104;Cilleruelo de Arriba;44;23;21
09;Burgos;105;Ciruelos de Cervera;99;58;41
09;Burgos;108;Cogollos;557;302;255
09;Burgos;109;Condado de Treviño;1342;745;597
09;Burgos;110;Contreras;77;49;28
09;Burgos;112;Coruña del Conde;109;68;41
09;Burgos;113;Covarrubias;552;296;256
09;Burgos;114;Cubillo del Campo;92;51;41
09;Burgos;115;Cubo de Bureba;98;54;44
09;Burgos;117;Cueva de Roa, La;122;61;61
09;Burgos;119;Cuevas de San Clemente;46;18;28
09;Burgos;120;Encío;39;20;19
09;Burgos;122;Espinosa de Cervera;100;63;37
09;Burgos;124;Espinosa de los Monteros;1681;877;804
09;Burgos;123;Espinosa del Camino;45;27;18
09;Burgos;125;Estépar;589;355;234
09;Burgos;127;Fontioso;54;33;21
09;Burgos;128;Frandovínez;94;54;40
09;Burgos;129;Fresneda de la Sierra Tirón;95;61;34
09;Burgos;130;Fresneña;68;45;23
09;Burgos;131;Fresnillo de las Dueñas;660;340;320
09;Burgos;132;Fresno de Río Tirón;186;113;73
09;Burgos;133;Fresno de Rodilla;44;25;19
09;Burgos;134;Frías;252;131;121
09;Burgos;135;Fuentebureba;45;25;20
09;Burgos;136;Fuentecén;212;117;95
09;Burgos;137;Fuentelcésped;238;121;117
09;Burgos;138;Fuentelisendo;96;51;45
09;Burgos;139;Fuentemolinos;100;67;33
09;Burgos;140;Fuentenebro;119;73;46
09;Burgos;141;Fuentespina;757;391;366
09;Burgos;143;Galbarros;29;18;11
09;Burgos;144;Gallega, La;45;29;16
09;Burgos;148;Grijalba;111;56;55
09;Burgos;149;Grisaleña;37;27;10
09;Burgos;151;Gumiel de Izán;556;314;242
09;Burgos;152;Gumiel de Mercado;363;198;165
09;Burgos;154;Hacinas;143;86;57
09;Burgos;155;Haza;30;19;11
09;Burgos;159;Hontanas;71;44;27
09;Burgos;160;Hontangas;90;60;30
09;Burgos;162;Hontoria de la Cantera;146;76;70
09;Burgos;164;Hontoria de Valdearados;180;107;73
09;Burgos;163;Hontoria del Pinar;661;369;292
09;Burgos;166;Hormazas, Las;102;58;44
09;Burgos;167;Hornillos del Camino;59;32;27
09;Burgos;168;Horra, La;340;184;156
09;Burgos;169;Hortigüela;105;71;34
09;Burgos;170;Hoyales de Roa;233;121;112
09;Burgos;172;Huérmeces;185;100;85
09;Burgos;173;Huerta de Arriba;131;77;54
09;Burgos;174;Huerta de Rey;923;499;424
09;Burgos;175;Humada;118;80;38
09;Burgos;176;Hurones;65;44;21
09;Burgos;177;Ibeas de Juarros;1404;753;651
09;Burgos;178;Ibrillos;40;26;14
09;Burgos;179;Iglesiarrubia;38;21;17
09;Burgos;180;Iglesias;145;79;66
09;Burgos;181;Isar;294;151;143
09;Burgos;182;Itero del Castillo;80;45;35
09;Burgos;183;Jaramillo de la Fuente;48;30;18
09;Burgos;184;Jaramillo Quemado;7;6;1
09;Burgos;189;Junta de Traslaloma;132;73;59
09;Burgos;190;Junta de Villalba de Losa;88;49;39
09;Burgos;191;Jurisdicción de Lara;33;19;14
09;Burgos;192;Jurisdicción de San Zadornil;56;32;24
09;Burgos;194;Lerma;2529;1270;1259
09;Burgos;195;Llano de Bureba;58;37;21
09;Burgos;196;Madrigal del Monte;143;88;55
09;Burgos;197;Madrigalejo del Monte;166;110;56
09;Burgos;198;Mahamud;109;60;49
09;Burgos;199;Mambrilla de Castrejón;103;61;42
09;Burgos;200;Mambrillas de Lara;58;35;23
09;Burgos;201;Mamolar;28;21;7
09;Burgos;202;Manciles;22;14;8
09;Burgos;206;Mazuela;57;33;24
09;Burgos;208;Mecerreyes;200;106;94
09;Burgos;209;Medina de Pomar;5728;2914;2814
09;Burgos;211;Melgar de Fernamental;1559;840;719
09;Burgos;213;Merindad de Cuesta-Urria;297;163;134
09;Burgos;214;Merindad de Montija;725;432;293
09;Burgos;906;Merindad de Río Ubierna;1444;804;640
09;Burgos;215;Merindad de Sotoscueva;409;225;184
09;Burgos;216;Merindad de Valdeporres;423;220;203
09;Burgos;217;Merindad de Valdivielso;388;223;165
09;Burgos;218;Milagros;439;240;199
09;Burgos;219;Miranda de Ebro;35522;17469;18053
09;Burgos;220;Miraveche;71;45;26
09;Burgos;221;Modúbar de la Emparedada;695;376;319
09;Burgos;223;Monasterio de la Sierra;44;28;16
09;Burgos;224;Monasterio de Rodilla;178;101;77
09;Burgos;225;Moncalvillo;85;50;35
09;Burgos;226;Monterrubio de la Demanda;56;35;21
09;Burgos;227;Montorio;149;78;71
09;Burgos;228;Moradillo de Roa;171;93;78
09;Burgos;229;Nava de Roa;227;121;106
09;Burgos;230;Navas de Bureba;33;16;17
09;Burgos;231;Nebreda;58;42;16
09;Burgos;232;Neila;154;89;65
09;Burgos;235;Olmedillo de Roa;179;104;75
09;Burgos;236;Olmillos de Muñó;35;20;15
09;Burgos;238;Oña;1017;540;477
09;Burgos;239;Oquillas;53;31;22
09;Burgos;241;Orbaneja Riopico;336;181;155
09;Burgos;242;Padilla de Abajo;75;45;30
09;Burgos;243;Padilla de Arriba;75;47;28
09;Burgos;244;Padrones de Bureba;50;23;27
09;Burgos;246;Palacios de la Sierra;725;368;357
09;Burgos;247;Palacios de Riopisuerga;25;12;13
09;Burgos;248;Palazuelos de la Sierra;80;47;33
09;Burgos;249;Palazuelos de Muñó;53;30;23
09;Burgos;250;Pampliega;291;156;135
09;Burgos;251;Pancorbo;434;235;199
09;Burgos;253;Pardilla;117;70;47
09;Burgos;255;Partido de la Sierra en Tobalina;86;52;34
09;Burgos;256;Pedrosa de Duero;484;276;208
09;Burgos;259;Pedrosa de Río Úrbel;240;141;99
09;Burgos;257;Pedrosa del Páramo;89;53;36
09;Burgos;258;Pedrosa del Príncipe;175;95;80
09;Burgos;261;Peñaranda de Duero;528;263;265
09;Burgos;262;Peral de Arlanza;169;89;80
09;Burgos;265;Piérnigas;51;33;18
09;Burgos;266;Pineda de la Sierra;106;66;40
09;Burgos;267;Pineda Trasmonte;113;65;48
09;Burgos;268;Pinilla de los Barruecos;95;54;41
09;Burgos;269;Pinilla de los Moros;35;20;15
09;Burgos;270;Pinilla Trasmonte;171;97;74
09;Burgos;272;Poza de la Sal;287;152;135
09;Burgos;273;Prádanos de Bureba;55;34;21
09;Burgos;274;Pradoluengo;1163;589;574
09;Burgos;275;Presencio;162;100;62
09;Burgos;276;Puebla de Arganzón, La;506;274;232
09;Burgos;277;Puentedura;110;76;34
09;Burgos;279;Quemada;231;137;94
09;Burgos;281;Quintana del Pidio;151;79;72
09;Burgos;280;Quintanabureba;27;15;12
09;Burgos;283;Quintanaélez;46;24;22
09;Burgos;287;Quintanaortuño;263;149;114
09;Burgos;288;Quintanapalla;112;64;48
09;Burgos;289;Quintanar de la Sierra;1658;879;779
09;Burgos;292;Quintanavides;76;47;29
09;Burgos;294;Quintanilla de la Mata;112;67;45
09;Burgos;901;Quintanilla del Agua y Tordueles;373;198;175
09;Burgos;295;Quintanilla del Coco;54;26;28
09;Burgos;298;Quintanilla San García;81;49;32
09;Burgos;301;Quintanilla Vivar;813;430;383
09;Burgos;297;Quintanillas, Las;370;218;152
09;Burgos;302;Rabanera del Pinar;105;65;40
09;Burgos;303;Rábanos;81;49;32
09;Burgos;304;Rabé de las Calzadas;220;110;110
09;Burgos;306;Rebolledo de la Torre;102;56;46
09;Burgos;307;Redecilla del Camino;115;73;42
09;Burgos;308;Redecilla del Campo;66;37;29
09;Burgos;309;Regumiel de la Sierra;340;181;159
09;Burgos;310;Reinoso;15;10;5
09;Burgos;311;Retuerta;63;39;24
09;Burgos;314;Revilla del Campo;95;59;36
09;Burgos;316;Revilla Vallejera;108;66;42
09;Burgos;312;Revilla y Ahedo, La;103;58;45
09;Burgos;315;Revillarruz;532;273;259
09;Burgos;317;Rezmondo;19;6;13
09;Burgos;318;Riocavado de la Sierra;60;39;21
09;Burgos;321;Roa;2183;1099;1084
09;Burgos;323;Rojas;67;47;20
09;Burgos;325;Royuela de Río Franco;181;109;72
09;Burgos;326;Rubena;191;113;78
09;Burgos;327;Rublacedo de Abajo;34;18;16
09;Burgos;328;Rucandio;74;36;38
09;Burgos;329;Salas de Bureba;130;73;57
09;Burgos;330;Salas de los Infantes;1965;1016;949
09;Burgos;332;Saldaña de Burgos;182;99;83
09;Burgos;334;Salinillas de Bureba;49;40;9
09;Burgos;335;San Adrián de Juarros;89;56;33
09;Burgos;337;San Juan del Monte;151;83;68
09;Burgos;338;San Mamés de Burgos;288;163;125
09;Burgos;339;San Martín de Rubiales;143;83;60
09;Burgos;340;San Millán de Lara;76;54;22
09;Burgos;360;San Vicente del Valle;24;19;5
09;Burgos;343;Santa Cecilia;102;63;39
09;Burgos;345;Santa Cruz de la Salceda;145;87;58
09;Burgos;346;Santa Cruz del Valle Urbión;97;63;34
09;Burgos;347;Santa Gadea del Cid;148;76;72
09;Burgos;348;Santa Inés;142;80;62
09;Burgos;350;Santa María del Campo;527;286;241
09;Burgos;351;Santa María del Invierno;63;46;17
09;Burgos;352;Santa María del Mercadillo;104;69;35
09;Burgos;353;Santa María Rivarredonda;90;57;33
09;Burgos;354;Santa Olalla de Bureba;35;26;9
09;Burgos;355;Santibáñez de Esgueva;83;46;37
09;Burgos;356;Santibáñez del Val;48;31;17
09;Burgos;358;Santo Domingo de Silos;279;173;106
09;Burgos;361;Sargentes de la Lora;117;66;51
09;Burgos;362;Sarracín;252;135;117
09;Burgos;363;Sasamón;983;561;422
09;Burgos;365;Sequera de Haza, La;31;22;9
09;Burgos;366;Solarana;74;42;32
09;Burgos;368;Sordillos;28;17;11
09;Burgos;369;Sotillo de la Ribera;490;250;240
09;Burgos;372;Sotragero;273;147;126
09;Burgos;373;Sotresgudo;440;253;187
09;Burgos;374;Susinos del Páramo;103;64;39
09;Burgos;375;Tamarón;43;23;20
09;Burgos;377;Tardajos;771;409;362
09;Burgos;378;Tejada;31;17;14
09;Burgos;380;Terradillos de Esgueva;78;37;41
09;Burgos;381;Tinieblas de la Sierra;36;21;15
09;Burgos;382;Tobar;25;18;7
09;Burgos;384;Tordómar;336;186;150
09;Burgos;386;Torrecilla del Monte;67;38;29
09;Burgos;387;Torregalindo;125;80;45
09;Burgos;388;Torrelara;33;18;15
09;Burgos;389;Torrepadre;69;42;27
09;Burgos;390;Torresandino;634;340;294
09;Burgos;391;Tórtoles de Esgueva;448;237;211
09;Burgos;392;Tosantos;54;30;24
09;Burgos;394;Trespaderne;783;394;389
09;Burgos;395;Tubilla del Agua;135;83;52
09;Burgos;396;Tubilla del Lago;164;89;75
09;Burgos;398;Úrbel del Castillo;74;50;24
09;Burgos;400;Vadocondes;353;200;153
09;Burgos;403;Valdeande;106;62;44
09;Burgos;405;Valdezate;142;81;61
09;Burgos;406;Valdorros;313;179;134
09;Burgos;408;Vallarta de Bureba;42;26;16
09;Burgos;904;Valle de las Navas;520;302;218
09;Burgos;908;Valle de Losa;490;291;199
09;Burgos;409;Valle de Manzanedo;120;66;54
09;Burgos;410;Valle de Mena;3726;1906;1820
09;Burgos;411;Valle de Oca;163;98;65
09;Burgos;902;Valle de Santibáñez;500;282;218
09;Burgos;905;Valle de Sedano;436;246;190
09;Burgos;412;Valle de Tobalina;954;516;438
09;Burgos;413;Valle de Valdebezana;475;247;228
09;Burgos;414;Valle de Valdelaguna;187;111;76
09;Burgos;415;Valle de Valdelucio;326;179;147
09;Burgos;416;Valle de Zamanzas;66;36;30
09;Burgos;417;Vallejera;43;24;19
09;Burgos;418;Valles de Palenzuela;81;42;39
09;Burgos;419;Valluércanes;72;46;26
09;Burgos;407;Valmala;28;14;14
09;Burgos;422;Vid de Bureba, La;33;19;14
09;Burgos;421;Vid y Barrios, La;259;149;110
09;Burgos;423;Vileña;28;18;10
09;Burgos;427;Villadiego;1492;824;668
09;Burgos;428;Villaescusa de Roa;107;60;47
09;Burgos;429;Villaescusa la Sombría;58;42;16
09;Burgos;430;Villaespasa;23;14;9
09;Burgos;431;Villafranca Montes de Oca;122;74;48
09;Burgos;432;Villafruela;186;109;77
09;Burgos;433;Villagalijo;62;37;25
09;Burgos;434;Villagonzalo Pedernales;1827;959;868
09;Burgos;437;Villahoz;293;158;135
09;Burgos;438;Villalba de Duero;699;362;337
09;Burgos;439;Villalbilla de Burgos;1407;767;640
09;Burgos;440;Villalbilla de Gumiel;81;50;31
09;Burgos;441;Villaldemiro;94;54;40
09;Burgos;442;Villalmanzo;427;233;194
09;Burgos;443;Villamayor de los Montes;170;81;89
09;Burgos;444;Villamayor de Treviño;63;32;31
09;Burgos;445;Villambistia;44;32;12
09;Burgos;446;Villamedianilla;12;7;5
09;Burgos;447;Villamiel de la Sierra;45;27;18
09;Burgos;448;Villangómez;214;132;82
09;Burgos;449;Villanueva de Argaño;119;65;54
09;Burgos;450;Villanueva de Carazo;27;16;11
09;Burgos;451;Villanueva de Gumiel;279;146;133
09;Burgos;454;Villanueva de Teba;43;28;15
09;Burgos;455;Villaquirán de la Puebla;45;28;17
09;Burgos;456;Villaquirán de los Infantes;158;82;76
09;Burgos;903;Villarcayo de Merindad de Castilla la Vieja;4097;2098;1999
09;Burgos;458;Villariezo;644;357;287
09;Burgos;460;Villasandino;185;108;77
09;Burgos;463;Villasur de Herreros;268;164;104
09;Burgos;464;Villatuelda;41;21;20
09;Burgos;466;Villaverde del Monte;115;66;49
09;Burgos;467;Villaverde-Mogina;74;50;24
09;Burgos;471;Villayerno Morquillas;186;95;91
09;Burgos;472;Villazopeque;54;33;21
09;Burgos;473;Villegas;87;49;38
09;Burgos;476;Villoruebo;72;47;25
09;Burgos;424;Viloria de Rioja;41;24;17
09;Burgos;425;Vilviestre del Pinar;520;287;233
09;Burgos;478;Vizcaínos;46;32;14
09;Burgos;480;Zael;112;59;53
09;Burgos;482;Zarzosa de Río Pisuerga;35;21;14
09;Burgos;483;Zazuar;210;110;100
09;Burgos;485;Zuñeda;56;33;23
10;Cáceres;001;Abadía;331;184;147
10;Cáceres;002;Abertura;407;205;202
10;Cáceres;003;Acebo;579;292;287
10;Cáceres;004;Acehúche;801;405;396
10;Cáceres;005;Aceituna;607;312;295
10;Cáceres;006;Ahigal;1372;706;666
10;Cáceres;903;Alagón del Río;932;464;468
10;Cáceres;007;Albalá;689;364;325
10;Cáceres;008;Alcántara;1468;736;732
10;Cáceres;009;Alcollarín;289;146;143
10;Cáceres;010;Alcuéscar;2593;1351;1242
10;Cáceres;012;Aldea del Cano;600;286;314
10;Cáceres;013;Aldea del Obispo, La;303;162;141
10;Cáceres;011;Aldeacentenera;578;296;282
10;Cáceres;014;Aldeanueva de la Vera;2066;1015;1051
10;Cáceres;015;Aldeanueva del Camino;735;361;374
10;Cáceres;016;Aldehuela de Jerte;364;192;172
10;Cáceres;017;Alía;834;421;413
10;Cáceres;018;Aliseda;1835;934;901
10;Cáceres;019;Almaraz;1744;895;849
10;Cáceres;020;Almoharín;1811;894;917
10;Cáceres;021;Arroyo de la Luz;5811;2889;2922
10;Cáceres;023;Arroyomolinos;797;413;384
10;Cáceres;022;Arroyomolinos de la Vera;443;223;220
10;Cáceres;024;Baños de Montemayor;759;354;405
10;Cáceres;025;Barrado;401;207;194
10;Cáceres;026;Belvís de Monroy;725;381;344
10;Cáceres;027;Benquerencia;81;47;34
10;Cáceres;028;Berrocalejo;100;55;45
10;Cáceres;029;Berzocana;423;229;194
10;Cáceres;030;Bohonal de Ibor;500;258;242
10;Cáceres;031;Botija;175;93;82
10;Cáceres;032;Brozas;1826;912;914
10;Cáceres;033;Cabañas del Castillo;431;225;206
10;Cáceres;034;Cabezabellosa;344;174;170
10;Cáceres;035;Cabezuela del Valle;2194;1121;1073
10;Cáceres;036;Cabrero;326;179;147
10;Cáceres;037;Cáceres;96126;46067;50059
10;Cáceres;038;Cachorrilla;82;40;42
10;Cáceres;039;Cadalso;431;218;213
10;Cáceres;040;Calzadilla;475;243;232
10;Cáceres;041;Caminomorisco;1194;623;571
10;Cáceres;042;Campillo de Deleitosa;79;35;44
10;Cáceres;043;Campo Lugar;833;415;418
10;Cáceres;044;Cañamero;1614;838;776
10;Cáceres;045;Cañaveral;1031;510;521
10;Cáceres;046;Carbajo;200;104;96
10;Cáceres;047;Carcaboso;1100;547;553
10;Cáceres;048;Carrascalejo;216;108;108
10;Cáceres;049;Casar de Cáceres;4469;2187;2282
10;Cáceres;050;Casar de Palomero;1133;578;555
10;Cáceres;051;Casares de las Hurdes;417;209;208
10;Cáceres;052;Casas de Don Antonio;174;86;88
10;Cáceres;053;Casas de Don Gómez;289;155;134
10;Cáceres;056;Casas de Millán;567;289;278
10;Cáceres;057;Casas de Miravete;132;83;49
10;Cáceres;054;Casas del Castañar;568;279;289
10;Cáceres;055;Casas del Monte;820;424;396
10;Cáceres;058;Casatejada;1360;717;643
10;Cáceres;059;Casillas de Coria;349;170;179
10;Cáceres;060;Castañar de Ibor;1054;549;505
10;Cáceres;061;Ceclavín;1840;933;907
10;Cáceres;062;Cedillo;440;231;209
10;Cáceres;063;Cerezo;165;81;84
10;Cáceres;064;Cilleros;1624;818;806
10;Cáceres;065;Collado de la Vera;195;106;89
10;Cáceres;066;Conquista de la Sierra;185;108;77
10;Cáceres;067;Coria;12478;6134;6344
10;Cáceres;068;Cuacos de Yuste;841;439;402
10;Cáceres;069;Cumbre, La;848;430;418
10;Cáceres;070;Deleitosa;709;355;354
10;Cáceres;071;Descargamaría;123;72;51
10;Cáceres;072;Eljas;908;469;439
10;Cáceres;073;Escurial;855;453;402
10;Cáceres;075;Fresnedoso de Ibor;268;145;123
10;Cáceres;076;Galisteo;918;457;461
10;Cáceres;077;Garciaz;709;365;344
10;Cáceres;079;Garganta la Olla;957;504;453
10;Cáceres;078;Garganta, La;378;208;170
10;Cáceres;080;Gargantilla;389;204;185
10;Cáceres;081;Gargüera;127;72;55
10;Cáceres;082;Garrovillas de Alconétar;2034;1005;1029
10;Cáceres;083;Garvín;95;52;43
10;Cáceres;084;Gata;1447;751;696
10;Cáceres;085;Gordo, El;367;193;174
10;Cáceres;086;Granja, La;328;168;160
10;Cáceres;087;Guadalupe;1862;926;936
10;Cáceres;088;Guijo de Coria;197;105;92
10;Cáceres;089;Guijo de Galisteo;1513;769;744
10;Cáceres;090;Guijo de Granadilla;530;274;256
10;Cáceres;091;Guijo de Santa Bárbara;387;204;183
10;Cáceres;092;Herguijuela;286;150;136
10;Cáceres;093;Hernán-Pérez;448;219;229
10;Cáceres;094;Herrera de Alcántara;253;128;125
10;Cáceres;095;Herreruela;333;171;162
10;Cáceres;096;Hervás;3976;1952;2024
10;Cáceres;097;Higuera;113;71;42
10;Cáceres;098;Hinojal;401;208;193
10;Cáceres;099;Holguera;641;321;320
10;Cáceres;100;Hoyos;874;426;448
10;Cáceres;101;Huélaga;220;109;111
10;Cáceres;102;Ibahernando;544;272;272
10;Cáceres;103;Jaraicejo;465;228;237
10;Cáceres;104;Jaraíz de la Vera;6478;3240;3238
10;Cáceres;105;Jarandilla de la Vera;2828;1415;1413
10;Cáceres;106;Jarilla;136;65;71
10;Cáceres;107;Jerte;1261;623;638
10;Cáceres;108;Ladrillar;201;109;92
10;Cáceres;109;Logrosán;1994;1006;988
10;Cáceres;110;Losar de la Vera;2699;1380;1319
10;Cáceres;111;Madrigal de la Vera;1579;818;761
10;Cáceres;112;Madrigalejo;1751;881;870
10;Cáceres;113;Madroñera;2533;1256;1277
10;Cáceres;114;Majadas;1323;664;659
10;Cáceres;115;Malpartida de Cáceres;4122;2079;2043
10;Cáceres;116;Malpartida de Plasencia;4602;2276;2326
10;Cáceres;117;Marchagaz;207;105;102
10;Cáceres;118;Mata de Alcántara;305;157;148
10;Cáceres;119;Membrío;622;306;316
10;Cáceres;120;Mesas de Ibor;162;86;76
10;Cáceres;121;Miajadas;9607;4800;4807
10;Cáceres;122;Millanes;248;127;121
10;Cáceres;123;Mirabel;660;323;337
10;Cáceres;124;Mohedas de Granadilla;836;422;414
10;Cáceres;125;Monroy;954;490;464
10;Cáceres;126;Montánchez;1682;854;828
10;Cáceres;127;Montehermoso;5739;2917;2822
10;Cáceres;128;Moraleja;6750;3341;3409
10;Cáceres;129;Morcillo;371;171;200
10;Cáceres;130;Navaconcejo;1990;1005;985
10;Cáceres;131;Navalmoral de la Mata;17129;8252;8877
10;Cáceres;132;Navalvillar de Ibor;408;204;204
10;Cáceres;133;Navas del Madroño;1292;647;645
10;Cáceres;134;Navezuelas;637;323;314
10;Cáceres;135;Nuñomoral;1272;676;596
10;Cáceres;136;Oliva de Plasencia;303;173;130
10;Cáceres;137;Palomero;406;215;191
10;Cáceres;138;Pasarón de la Vera;632;304;328
10;Cáceres;139;Pedroso de Acim;80;43;37
10;Cáceres;140;Peraleda de la Mata;1369;697;672
10;Cáceres;141;Peraleda de San Román;310;162;148
10;Cáceres;142;Perales del Puerto;952;480;472
10;Cáceres;143;Pescueza;148;66;82
10;Cáceres;144;Pesga, La;1034;543;491
10;Cáceres;145;Piedras Albas;147;69;78
10;Cáceres;146;Pinofranqueado;1736;927;809
10;Cáceres;147;Piornal;1519;767;752
10;Cáceres;148;Plasencia;39913;19254;20659
10;Cáceres;149;Plasenzuela;492;251;241
10;Cáceres;150;Portaje;355;183;172
10;Cáceres;151;Portezuelo;218;115;103
10;Cáceres;152;Pozuelo de Zarzón;475;240;235
10;Cáceres;905;Pueblonuevo de Miramontes;791;402;389
10;Cáceres;153;Puerto de Santa Cruz;317;167;150
10;Cáceres;154;Rebollar;214;108;106
10;Cáceres;155;Riolobos;1231;635;596
10;Cáceres;156;Robledillo de Gata;91;50;41
10;Cáceres;157;Robledillo de la Vera;265;134;131
10;Cáceres;158;Robledillo de Trujillo;366;183;183
10;Cáceres;159;Robledollano;310;166;144
10;Cáceres;160;Romangordo;259;129;130
10;Cáceres;901;Rosalejo;1397;719;678
10;Cáceres;161;Ruanes;83;43;40
10;Cáceres;162;Salorino;565;294;271
10;Cáceres;163;Salvatierra de Santiago;312;155;157
10;Cáceres;164;San Martín de Trevejo;778;382;396
10;Cáceres;165;Santa Ana;262;140;122
10;Cáceres;166;Santa Cruz de la Sierra;327;167;160
10;Cáceres;167;Santa Cruz de Paniagua;323;180;143
10;Cáceres;168;Santa Marta de Magasca;282;140;142
10;Cáceres;169;Santiago de Alcántara;523;255;268
10;Cáceres;170;Santiago del Campo;252;126;126
10;Cáceres;171;Santibáñez el Alto;370;203;167
10;Cáceres;172;Santibáñez el Bajo;756;385;371
10;Cáceres;173;Saucedilla;851;443;408
10;Cáceres;174;Segura de Toro;183;90;93
10;Cáceres;175;Serradilla;1537;777;760
10;Cáceres;176;Serrejón;409;213;196
10;Cáceres;177;Sierra de Fuentes;1998;1017;981
10;Cáceres;178;Talaván;814;422;392
10;Cáceres;179;Talaveruela de la Vera;319;169;150
10;Cáceres;180;Talayuela;7371;3965;3406
10;Cáceres;181;Tejeda de Tiétar;788;415;373
10;Cáceres;904;Tiétar;902;481;421
10;Cáceres;182;Toril;148;96;52
10;Cáceres;183;Tornavacas;1132;603;529
10;Cáceres;184;Torno, El;860;448;412
10;Cáceres;187;Torre de Don Miguel;484;258;226
10;Cáceres;188;Torre de Santa María;534;265;269
10;Cáceres;185;Torrecilla de los Ángeles;624;336;288
10;Cáceres;186;Torrecillas de la Tiesa;1067;541;526
10;Cáceres;190;Torrejón el Rubio;565;283;282
10;Cáceres;189;Torrejoncillo;2935;1439;1496
10;Cáceres;191;Torremenga;599;321;278
10;Cáceres;192;Torremocha;798;399;399
10;Cáceres;193;Torreorgaz;1676;819;857
10;Cáceres;194;Torrequemada;565;268;297
10;Cáceres;195;Trujillo;9012;4394;4618
10;Cáceres;196;Valdastillas;321;166;155
10;Cáceres;197;Valdecañas de Tajo;110;59;51
10;Cáceres;198;Valdefuentes;1174;577;597
10;Cáceres;199;Valdehúncar;175;95;80
10;Cáceres;200;Valdelacasa de Tajo;348;184;164
10;Cáceres;201;Valdemorales;200;98;102
10;Cáceres;202;Valdeobispo;656;322;334
10;Cáceres;203;Valencia de Alcántara;5397;2643;2754
10;Cáceres;204;Valverde de la Vera;483;249;234
10;Cáceres;205;Valverde del Fresno;2309;1164;1145
10;Cáceres;902;Vegaviana;864;444;420
10;Cáceres;206;Viandar de la Vera;225;115;110
10;Cáceres;207;Villa del Campo;487;229;258
10;Cáceres;208;Villa del Rey;128;64;64
10;Cáceres;209;Villamesías;261;136;125
10;Cáceres;210;Villamiel;407;205;202
10;Cáceres;211;Villanueva de la Sierra;456;231;225
10;Cáceres;212;Villanueva de la Vera;2021;1013;1008
10;Cáceres;214;Villar de Plasencia;235;127;108
10;Cáceres;213;Villar del Pedroso;599;310;289
10;Cáceres;215;Villasbuenas de Gata;354;173;181
10;Cáceres;216;Zarza de Granadilla;1805;915;890
10;Cáceres;217;Zarza de Montánchez;571;287;284
10;Cáceres;218;Zarza la Mayor;1228;610;618
10;Cáceres;219;Zorita;1367;699;668
11;Cádiz;001;Alcalá de los Gazules;5219;2684;2535
11;Cádiz;002;Alcalá del Valle;5046;2538;2508
11;Cádiz;003;Algar;1413;721;692
11;Cádiz;004;Algeciras;121957;60120;61837
11;Cádiz;005;Algodonales;5550;2824;2726
11;Cádiz;006;Arcos de la Frontera;30700;15318;15382
11;Cádiz;007;Barbate;22518;11303;11215
11;Cádiz;008;Barrios, Los;23642;11825;11817
11;Cádiz;901;Benalup-Casas Viejas;6929;3518;3411
11;Cádiz;009;Benaocaz;671;356;315
11;Cádiz;010;Bornos;7670;3824;3846
11;Cádiz;011;Bosque, El;2145;1083;1062
11;Cádiz;012;Cádiz;116027;54918;61109
11;Cádiz;013;Castellar de la Frontera;3049;1528;1521
11;Cádiz;015;Chiclana de la Frontera;84489;42289;42200
11;Cádiz;016;Chipiona;19123;9586;9537
11;Cádiz;014;Conil de la Frontera;22529;11345;11184
11;Cádiz;017;Espera;3860;1939;1921
11;Cádiz;018;Gastor, El;1752;905;847
11;Cádiz;019;Grazalema;2027;1006;1021
11;Cádiz;020;Jerez de la Frontera;212749;103897;108852
11;Cádiz;021;Jimena de la Frontera;6951;3568;3383
11;Cádiz;022;Línea de la Concepción, La;63147;30978;32169
11;Cádiz;023;Medina Sidonia;11708;5950;5758
11;Cádiz;024;Olvera;8113;3971;4142
11;Cádiz;025;Paterna de Rivera;5470;2820;2650
11;Cádiz;026;Prado del Rey;5605;2807;2798
11;Cádiz;027;Puerto de Santa María, El;88405;43295;45110
11;Cádiz;028;Puerto Real;41627;20926;20701
11;Cádiz;029;Puerto Serrano;6941;3515;3426
11;Cádiz;030;Rota;29109;14505;14604
11;Cádiz;031;San Fernando;94979;46427;48552
11;Cádiz;902;San José del Valle;4418;2257;2161
11;Cádiz;903;San Martín del Tesorillo;2753;1430;1323
11;Cádiz;033;San Roque;31218;15579;15639
11;Cádiz;032;Sanlúcar de Barrameda;68684;34209;34475
11;Cádiz;034;Setenil de las Bodegas;2769;1430;1339
11;Cádiz;035;Tarifa;18162;9152;9010
11;Cádiz;036;Torre Alháquime;790;391;399
11;Cádiz;037;Trebujena;7028;3501;3527
11;Cádiz;038;Ubrique;16597;8203;8394
11;Cádiz;039;Vejer de la Frontera;12624;6289;6335
11;Cádiz;040;Villaluenga del Rosario;455;243;212
11;Cádiz;041;Villamartín;12150;6109;6041
11;Cádiz;042;Zahara;1387;709;678
39;Cantabria;001;Alfoz de Lloredo;2416;1249;1167
39;Cantabria;002;Ampuero;4288;2166;2122
39;Cantabria;003;Anievas;267;141;126
39;Cantabria;004;Arenas de Iguña;1679;856;823
39;Cantabria;005;Argoños;1748;898;850
39;Cantabria;006;Arnuero;2103;1062;1041
39;Cantabria;007;Arredondo;452;253;199
39;Cantabria;008;Astillero, El;18111;8853;9258
39;Cantabria;009;Bárcena de Cicero;4246;2187;2059
39;Cantabria;010;Bárcena de Pie de Concha;678;341;337
39;Cantabria;011;Bareyo;1950;985;965
39;Cantabria;012;Cabezón de la Sal;8301;3983;4318
39;Cantabria;013;Cabezón de Liébana;616;350;266
39;Cantabria;014;Cabuérniga;1000;537;463
39;Cantabria;015;Camaleño;936;534;402
39;Cantabria;016;Camargo;30260;14806;15454
39;Cantabria;027;Campoo de Enmedio;3714;1902;1812
39;Cantabria;017;Campoo de Yuso;669;364;305
39;Cantabria;018;Cartes;5747;2884;2863
39;Cantabria;019;Castañeda;2914;1482;1432
39;Cantabria;020;Castro-Urdiales;32069;15866;16203
39;Cantabria;021;Cieza;538;275;263
39;Cantabria;022;Cillorigo de Liébana;1305;680;625
39;Cantabria;023;Colindres;8484;4178;4306
39;Cantabria;024;Comillas;2141;1010;1131
39;Cantabria;025;Corrales de Buelna, Los;10841;5290;5551
39;Cantabria;026;Corvera de Toranzo;2039;1036;1003
39;Cantabria;028;Entrambasaguas;5163;2590;2573
39;Cantabria;029;Escalante;779;399;380
39;Cantabria;030;Guriezo;2354;1218;1136
39;Cantabria;031;Hazas de Cesto;1569;773;796
39;Cantabria;032;Hermandad de Campoo de Suso;1603;894;709
39;Cantabria;033;Herrerías;605;341;264
39;Cantabria;034;Lamasón;272;173;99
39;Cantabria;035;Laredo;11025;5217;5808
39;Cantabria;036;Liendo;1204;621;583
39;Cantabria;037;Liérganes;2379;1168;1211
39;Cantabria;038;Limpias;1879;926;953
39;Cantabria;039;Luena;593;321;272
39;Cantabria;040;Marina de Cudeyo;5125;2547;2578
39;Cantabria;041;Mazcuerras;2105;1082;1023
39;Cantabria;042;Medio Cudeyo;7556;3663;3893
39;Cantabria;043;Meruelo;2028;1013;1015
39;Cantabria;044;Miengo;4741;2407;2334
39;Cantabria;045;Miera;380;198;182
39;Cantabria;046;Molledo;1504;746;758
39;Cantabria;047;Noja;2556;1274;1282
39;Cantabria;048;Penagos;2142;1078;1064
39;Cantabria;049;Peñarrubia;319;172;147
39;Cantabria;050;Pesaguero;292;169;123
39;Cantabria;051;Pesquera;78;47;31
39;Cantabria;052;Piélagos;25559;12669;12890
39;Cantabria;053;Polaciones;232;147;85
39;Cantabria;054;Polanco;5896;2912;2984
39;Cantabria;055;Potes;1343;650;693
39;Cantabria;056;Puente Viesgo;2854;1450;1404
39;Cantabria;057;Ramales de la Victoria;2876;1437;1439
39;Cantabria;058;Rasines;931;478;453
39;Cantabria;059;Reinosa;9003;4235;4768
39;Cantabria;060;Reocín;8384;4142;4242
39;Cantabria;061;Ribamontán al Mar;4437;2250;2187
39;Cantabria;062;Ribamontán al Monte;2276;1181;1095
39;Cantabria;063;Rionansa;1047;581;466
39;Cantabria;064;Riotuerto;1601;772;829
39;Cantabria;065;Rozas de Valdearroyo, Las;260;147;113
39;Cantabria;066;Ruente;1016;552;464
39;Cantabria;067;Ruesga;839;461;378
39;Cantabria;068;Ruiloba;740;378;362
39;Cantabria;069;San Felices de Buelna;2361;1192;1169
39;Cantabria;070;San Miguel de Aguayo;140;73;67
39;Cantabria;071;San Pedro del Romeral;507;283;224
39;Cantabria;072;San Roque de Riomiera;356;213;143
39;Cantabria;080;San Vicente de la Barquera;4124;2037;2087
39;Cantabria;073;Santa Cruz de Bezana;13095;6443;6652
39;Cantabria;074;Santa María de Cayón;9159;4575;4584
39;Cantabria;075;Santander;172539;79555;92984
39;Cantabria;076;Santillana del Mar;4207;2056;2151
39;Cantabria;077;Santiurde de Reinosa;255;147;108
39;Cantabria;078;Santiurde de Toranzo;1629;847;782
39;Cantabria;079;Santoña;11024;5374;5650
39;Cantabria;081;Saro;504;262;242
39;Cantabria;082;Selaya;1891;951;940
39;Cantabria;083;Soba;1180;655;525
39;Cantabria;084;Solórzano;1047;563;484
39;Cantabria;085;Suances;8782;4314;4468
39;Cantabria;086;Tojos, Los;387;227;160
39;Cantabria;087;Torrelavega;51494;24302;27192
39;Cantabria;088;Tresviso;62;44;18
39;Cantabria;089;Tudanca;141;99;42
39;Cantabria;090;Udías;934;472;462
39;Cantabria;095;Val de San Vicente;2728;1403;1325
39;Cantabria;091;Valdáliga;2182;1129;1053
39;Cantabria;092;Valdeolea;947;502;445
39;Cantabria;093;Valdeprado del Río;337;188;149
39;Cantabria;094;Valderredible;989;555;434
39;Cantabria;101;Valle de Villaverde;283;154;129
39;Cantabria;096;Vega de Liébana;736;387;349
39;Cantabria;097;Vega de Pas;763;403;360
39;Cantabria;098;Villacarriedo;1612;845;767
39;Cantabria;099;Villaescusa;3899;1921;1978
39;Cantabria;100;Villafufre;1003;527;476
39;Cantabria;102;Voto;2724;1456;1268
12;Castellón/Castelló;002;Aín;127;64;63
12;Castellón/Castelló;003;Albocàsser;1241;630;611
12;Castellón/Castelló;004;Alcalà de Xivert;6680;3412;3268
12;Castellón/Castelló;005;Alcora, l';10405;5255;5150
12;Castellón/Castelló;006;Alcudia de Veo;190;103;87
12;Castellón/Castelló;007;Alfondeguilla;866;440;426
12;Castellón/Castelló;008;Algimia de Almonacid;263;149;114
12;Castellón/Castelló;009;Almassora;26270;13224;13046
12;Castellón/Castelló;010;Almedíjar;254;141;113
12;Castellón/Castelló;011;Almenara;5998;3013;2985
12;Castellón/Castelló;901;Alqueries, les/Alquerías del Niño Perdido;4449;2209;2240
12;Castellón/Castelló;012;Altura;3528;1822;1706
12;Castellón/Castelló;013;Arañuel;150;78;72
12;Castellón/Castelló;014;Ares del Maestrat;186;107;79
12;Castellón/Castelló;015;Argelita;118;72;46
12;Castellón/Castelló;016;Artana;1947;992;955
12;Castellón/Castelló;001;Atzeneta del Maestrat;1276;649;627
12;Castellón/Castelló;017;Ayódar;159;86;73
12;Castellón/Castelló;018;Azuébar;315;165;150
12;Castellón/Castelló;020;Barracas;162;93;69
12;Castellón/Castelló;022;Bejís;380;215;165
12;Castellón/Castelló;024;Benafer;152;81;71
12;Castellón/Castelló;025;Benafigos;142;80;62
12;Castellón/Castelló;026;Benassal;1068;550;518
12;Castellón/Castelló;027;Benicarló;26912;13408;13504
12;Castellón/Castelló;028;Benicasim/Benicàssim;18192;9046;9146
12;Castellón/Castelló;029;Benlloc;1033;518;515
12;Castellón/Castelló;021;Betxí;5645;2792;2853
12;Castellón/Castelló;032;Borriana/Burriana;34683;17224;17459
12;Castellón/Castelló;031;Borriol;5360;2736;2624
12;Castellón/Castelló;033;Cabanes;2958;1509;1449
12;Castellón/Castelló;034;Càlig;1950;989;961
12;Castellón/Castelló;036;Canet lo Roig;674;330;344
12;Castellón/Castelló;037;Castell de Cabres;17;9;8
12;Castellón/Castelló;038;Castellfort;183;100;83
12;Castellón/Castelló;039;Castellnovo;917;461;456
12;Castellón/Castelló;040;Castellón de la Plana/Castelló de la Plana;171728;83072;88656
12;Castellón/Castelló;041;Castillo de Villamalefa;107;72;35
12;Castellón/Castelló;042;Catí;721;362;359
12;Castellón/Castelló;043;Caudiel;664;340;324
12;Castellón/Castelló;044;Cervera del Maestre;575;286;289
12;Castellón/Castelló;053;Chilches/Xilxes;2679;1383;1296
12;Castellón/Castelló;055;Chodos/Xodos;112;69;43
12;Castellón/Castelló;056;Chóvar;288;150;138
12;Castellón/Castelló;045;Cinctorres;391;192;199
12;Castellón/Castelló;046;Cirat;201;109;92
12;Castellón/Castelló;048;Cortes de Arenoso;318;172;146
12;Castellón/Castelló;049;Costur;524;277;247
12;Castellón/Castelló;050;Coves de Vinromà, les;1823;921;902
12;Castellón/Castelló;051;Culla;495;252;243
12;Castellón/Castelló;057;Eslida;759;383;376
12;Castellón/Castelló;058;Espadilla;71;42;29
12;Castellón/Castelló;059;Fanzara;267;137;130
12;Castellón/Castelló;060;Figueroles;523;261;262
12;Castellón/Castelló;061;Forcall;465;230;235
12;Castellón/Castelló;063;Fuente la Reina;52;28;24
12;Castellón/Castelló;064;Fuentes de Ayódar;87;50;37
12;Castellón/Castelló;065;Gaibiel;188;102;86
12;Castellón/Castelló;067;Geldo;635;316;319
12;Castellón/Castelló;068;Herbés;42;24;18
12;Castellón/Castelló;069;Higueras;54;31;23
12;Castellón/Castelló;070;Jana, la;675;341;334
12;Castellón/Castelló;071;Jérica;1548;798;750
12;Castellón/Castelló;074;Llosa, la;951;467;484
12;Castellón/Castelló;072;Llucena/Lucena del Cid;1302;653;649
12;Castellón/Castelló;073;Ludiente;141;78;63
12;Castellón/Castelló;075;Mata de Morella, la;166;90;76
12;Castellón/Castelló;076;Matet;84;43;41
12;Castellón/Castelló;077;Moncofa;6525;3374;3151
12;Castellón/Castelló;078;Montán;370;186;184
12;Castellón/Castelló;079;Montanejos;572;305;267
12;Castellón/Castelló;080;Morella;2430;1192;1238
12;Castellón/Castelló;081;Navajas;716;378;338
12;Castellón/Castelló;082;Nules;13103;6549;6554
12;Castellón/Castelló;083;Olocau del Rey;119;65;54
12;Castellón/Castelló;084;Onda;24859;12484;12375
12;Castellón/Castelló;085;Oropesa del Mar/Orpesa;9076;4660;4416
12;Castellón/Castelló;087;Palanques;30;18;12
12;Castellón/Castelló;088;Pavías;61;39;22
12;Castellón/Castelló;089;Peníscola/Peñíscola;7612;3849;3763
12;Castellón/Castelló;090;Pina de Montalgrao;111;59;52
12;Castellón/Castelló;093;Pobla de Benifassà, la;202;114;88
12;Castellón/Castelló;094;Pobla Tornesa, la;1211;618;593
12;Castellón/Castelló;091;Portell de Morella;197;101;96
12;Castellón/Castelló;092;Puebla de Arenoso;158;84;74
12;Castellón/Castelló;095;Ribesalbes;1174;610;564
12;Castellón/Castelló;096;Rossell;937;494;443
12;Castellón/Castelló;097;Sacañet;67;45;22
12;Castellón/Castelló;098;Salzadella, la;704;360;344
12;Castellón/Castelló;101;San Rafael del Río;469;233;236
12;Castellón/Castelló;902;Sant Joan de Moró;3159;1646;1513
12;Castellón/Castelló;099;Sant Jordi/San Jorge;972;520;452
12;Castellón/Castelló;100;Sant Mateu;1963;971;992
12;Castellón/Castelló;102;Santa Magdalena de Pulpis;768;405;363
12;Castellón/Castelló;104;Segorbe;8978;4427;4551
12;Castellón/Castelló;103;Serratella, la;101;52;49
12;Castellón/Castelló;105;Sierra Engarcerán;976;513;463
12;Castellón/Castelló;106;Soneja;1447;712;735
12;Castellón/Castelló;107;Sot de Ferrer;415;212;203
12;Castellón/Castelló;108;Sueras/Suera;525;279;246
12;Castellón/Castelló;109;Tales;825;416;409
12;Castellón/Castelló;110;Teresa;242;128;114
12;Castellón/Castelló;111;Tírig;419;213;206
12;Castellón/Castelló;112;Todolella;155;92;63
12;Castellón/Castelló;113;Toga;100;52;48
12;Castellón/Castelló;114;Torás;223;121;102
12;Castellón/Castelló;115;Toro, El;256;146;110
12;Castellón/Castelló;116;Torralba del Pinar;69;32;37
12;Castellón/Castelló;119;Torre d'En Besora, la;158;88;70
12;Castellón/Castelló;120;Torre d'en Doménec, la;180;92;88
12;Castellón/Castelló;117;Torreblanca;5528;2797;2731
12;Castellón/Castelló;118;Torrechiva;81;46;35
12;Castellón/Castelló;121;Traiguera;1378;695;683
12;Castellón/Castelló;122;Useras/Useres, les;962;500;462
12;Castellón/Castelló;124;Vall d'Alba;2807;1468;1339
12;Castellón/Castelló;125;Vall de Almonacid;269;133;136
12;Castellón/Castelló;126;Vall d'Uixó, la;31660;15631;16029
12;Castellón/Castelló;123;Vallat;49;21;28
12;Castellón/Castelló;127;Vallibona;69;39;30
12;Castellón/Castelló;128;Vilafamés;1842;997;845
12;Castellón/Castelló;129;Vilafranca/Villafranca del Cid;2200;1087;1113
12;Castellón/Castelló;132;Vilanova d'Alcolea;584;300;284
12;Castellón/Castelló;134;Vilar de Canes;169;88;81
12;Castellón/Castelló;135;Vila-real;50893;25282;25611
12;Castellón/Castelló;136;Vilavella, la;3157;1569;1588
12;Castellón/Castelló;130;Villahermosa del Río;489;268;221
12;Castellón/Castelló;131;Villamalur;62;37;25
12;Castellón/Castelló;133;Villanueva de Viver;61;34;27
12;Castellón/Castelló;137;Villores;39;19;20
12;Castellón/Castelló;138;Vinaròs;28682;14169;14513
12;Castellón/Castelló;139;Vistabella del Maestrat;339;186;153
12;Castellón/Castelló;140;Viver;1536;800;736
12;Castellón/Castelló;052;Xert;701;338;363
12;Castellón/Castelló;141;Zorita del Maestrazgo;114;59;55
12;Castellón/Castelló;142;Zucaina;171;97;74
51;Ceuta;001;Ceuta;84777;42912;41865
13;Ciudad Real;001;Abenójar;1375;711;664
13;Ciudad Real;002;Agudo;1659;830;829
13;Ciudad Real;003;Alamillo;486;249;237
13;Ciudad Real;004;Albaladejo;1158;601;557
13;Ciudad Real;005;Alcázar de San Juan;30576;14908;15668
13;Ciudad Real;006;Alcoba;583;297;286
13;Ciudad Real;007;Alcolea de Calatrava;1409;714;695
13;Ciudad Real;008;Alcubillas;477;239;238
13;Ciudad Real;009;Aldea del Rey;1657;843;814
13;Ciudad Real;010;Alhambra;1002;506;496
13;Ciudad Real;011;Almadén;5312;2536;2776
13;Ciudad Real;012;Almadenejos;415;217;198
13;Ciudad Real;013;Almagro;8896;4377;4519
13;Ciudad Real;014;Almedina;516;274;242
13;Ciudad Real;015;Almodóvar del Campo;6027;3027;3000
13;Ciudad Real;016;Almuradiel;772;383;389
13;Ciudad Real;017;Anchuras;327;164;163
13;Ciudad Real;903;Arenales de San Gregorio;589;300;289
13;Ciudad Real;018;Arenas de San Juan;1011;515;496
13;Ciudad Real;019;Argamasilla de Alba;6838;3418;3420
13;Ciudad Real;020;Argamasilla de Calatrava;5943;2994;2949
13;Ciudad Real;021;Arroba de los Montes;446;241;205
13;Ciudad Real;022;Ballesteros de Calatrava;373;186;187
13;Ciudad Real;023;Bolaños de Calatrava;11934;6090;5844
13;Ciudad Real;024;Brazatortas;1005;523;482
13;Ciudad Real;025;Cabezarados;322;173;149
13;Ciudad Real;026;Cabezarrubias del Puerto;481;252;229
13;Ciudad Real;027;Calzada de Calatrava;3719;1849;1870
13;Ciudad Real;028;Campo de Criptana;13414;6684;6730
13;Ciudad Real;029;Cañada de Calatrava;102;60;42
13;Ciudad Real;030;Caracuel de Calatrava;134;77;57
13;Ciudad Real;031;Carrión de Calatrava;3082;1542;1540
13;Ciudad Real;032;Carrizosa;1212;619;593
13;Ciudad Real;033;Castellar de Santiago;1897;962;935
13;Ciudad Real;038;Chillón;1816;877;939
13;Ciudad Real;034;Ciudad Real;74746;35401;39345
13;Ciudad Real;035;Corral de Calatrava;1123;545;578
13;Ciudad Real;036;Cortijos, Los;884;468;416
13;Ciudad Real;037;Cózar;969;482;487
13;Ciudad Real;039;Daimiel;17929;8970;8959
13;Ciudad Real;040;Fernán Caballero;1001;506;495
13;Ciudad Real;041;Fontanarejo;275;152;123
13;Ciudad Real;042;Fuencaliente;1036;538;498
13;Ciudad Real;043;Fuenllana;217;111;106
13;Ciudad Real;044;Fuente el Fresno;3220;1658;1562
13;Ciudad Real;045;Granátula de Calatrava;714;346;368
13;Ciudad Real;046;Guadalmez;725;350;375
13;Ciudad Real;047;Herencia;8390;4277;4113
13;Ciudad Real;048;Hinojosas de Calatrava;536;274;262
13;Ciudad Real;049;Horcajo de los Montes;883;444;439
13;Ciudad Real;050;Labores, Las;569;282;287
13;Ciudad Real;904;Llanos del Caudillo;719;354;365
13;Ciudad Real;051;Luciana;366;196;170
13;Ciudad Real;052;Malagón;7998;3939;4059
13;Ciudad Real;053;Manzanares;17997;8919;9078
13;Ciudad Real;054;Membrilla;6005;3009;2996
13;Ciudad Real;055;Mestanza;667;337;330
13;Ciudad Real;056;Miguelturra;15368;7742;7626
13;Ciudad Real;057;Montiel;1315;689;626
13;Ciudad Real;058;Moral de Calatrava;5271;2672;2599
13;Ciudad Real;059;Navalpino;228;118;110
13;Ciudad Real;060;Navas de Estena;298;161;137
13;Ciudad Real;061;Pedro Muñoz;7293;3650;3643
13;Ciudad Real;062;Picón;658;338;320
13;Ciudad Real;063;Piedrabuena;4395;2239;2156
13;Ciudad Real;064;Poblete;2626;1347;1279
13;Ciudad Real;065;Porzuna;3532;1810;1722
13;Ciudad Real;066;Pozuelo de Calatrava;3553;1816;1737
13;Ciudad Real;067;Pozuelos de Calatrava, Los;372;193;179
13;Ciudad Real;068;Puebla de Don Rodrigo;1178;650;528
13;Ciudad Real;069;Puebla del Príncipe;694;359;335
13;Ciudad Real;070;Puerto Lápice;924;460;464
13;Ciudad Real;071;Puertollano;47035;22753;24282
13;Ciudad Real;072;Retuerta del Bullaque;941;520;421
13;Ciudad Real;901;Robledo, El;1081;568;513
13;Ciudad Real;902;Ruidera;553;272;281
13;Ciudad Real;073;Saceruela;559;297;262
13;Ciudad Real;074;San Carlos del Valle;1120;574;546
13;Ciudad Real;075;San Lorenzo de Calatrava;213;117;96
13;Ciudad Real;076;Santa Cruz de los Cáñamos;522;250;272
13;Ciudad Real;077;Santa Cruz de Mudela;4107;2034;2073
13;Ciudad Real;078;Socuéllamos;12139;6103;6036
13;Ciudad Real;080;Solana del Pino;324;171;153
13;Ciudad Real;079;Solana, La;15479;7832;7647
13;Ciudad Real;081;Terrinches;678;346;332
13;Ciudad Real;082;Tomelloso;35873;17745;18128
13;Ciudad Real;083;Torralba de Calatrava;2977;1495;1482
13;Ciudad Real;084;Torre de Juan Abad;995;483;512
13;Ciudad Real;085;Torrenueva;2702;1357;1345
13;Ciudad Real;086;Valdemanco del Esteras;170;90;80
13;Ciudad Real;087;Valdepeñas;30077;14644;15433
13;Ciudad Real;088;Valenzuela de Calatrava;688;321;367
13;Ciudad Real;089;Villahermosa;1826;891;935
13;Ciudad Real;090;Villamanrique;1148;560;588
13;Ciudad Real;091;Villamayor de Calatrava;634;313;321
13;Ciudad Real;092;Villanueva de la Fuente;2078;1062;1016
13;Ciudad Real;093;Villanueva de los Infantes;4935;2446;2489
13;Ciudad Real;094;Villanueva de San Carlos;290;155;135
13;Ciudad Real;095;Villar del Pozo;75;41;34
13;Ciudad Real;096;Villarrubia de los Ojos;9814;4878;4936
13;Ciudad Real;097;Villarta de San Juan;2791;1410;1381
13;Ciudad Real;098;Viso del Marqués;2298;1109;1189
14;Córdoba;001;Adamuz;4192;2157;2035
14;Córdoba;002;Aguilar de la Frontera;13328;6678;6650
14;Córdoba;003;Alcaracejos;1486;723;763
14;Córdoba;004;Almedinilla;2391;1191;1200
14;Córdoba;005;Almodóvar del Río;7937;3963;3974
14;Córdoba;006;Añora;1527;752;775
14;Córdoba;007;Baena;19284;9829;9455
14;Córdoba;008;Belalcázar;3255;1572;1683
14;Córdoba;009;Belmez;2923;1418;1505
14;Córdoba;010;Benamejí;4966;2478;2488
14;Córdoba;011;Blázquez, Los;661;338;323
14;Córdoba;012;Bujalance;7417;3691;3726
14;Córdoba;013;Cabra;20341;9905;10436
14;Córdoba;014;Cañete de las Torres;2933;1512;1421
14;Córdoba;015;Carcabuey;2412;1226;1186
14;Córdoba;016;Cardeña;1490;740;750
14;Córdoba;017;Carlota, La;14061;7033;7028
14;Córdoba;018;Carpio, El;4383;2166;2217
14;Córdoba;019;Castro del Río;7809;3869;3940
14;Córdoba;020;Conquista;379;186;193
14;Córdoba;021;Córdoba;325701;156355;169346
14;Córdoba;022;Doña Mencía;4638;2249;2389
14;Córdoba;023;Dos Torres;2411;1202;1209
14;Córdoba;024;Encinas Reales;2254;1115;1139
14;Córdoba;025;Espejo;3329;1671;1658
14;Córdoba;026;Espiel;2397;1207;1190
14;Córdoba;027;Fernán-Núñez;9663;4840;4823
14;Córdoba;901;Fuente Carreteros;1131;578;553
14;Córdoba;028;Fuente la Lancha;351;182;169
14;Córdoba;029;Fuente Obejuna;4604;2374;2230
14;Córdoba;030;Fuente Palmera;9783;4886;4897
14;Córdoba;031;Fuente-Tójar;672;325;347
14;Córdoba;032;Granjuela, La;461;236;225
14;Córdoba;033;Guadalcázar;1583;794;789
14;Córdoba;902;Guijarrosa, La;1399;714;685
14;Córdoba;034;Guijo, El;355;185;170
14;Córdoba;035;Hinojosa del Duque;6788;3328;3460
14;Córdoba;036;Hornachuelos;4497;2239;2258
14;Córdoba;037;Iznájar;4261;2133;2128
14;Córdoba;038;Lucena;42605;21251;21354
14;Córdoba;039;Luque;2994;1503;1491
14;Córdoba;040;Montalbán de Córdoba;4489;2219;2270
14;Córdoba;041;Montemayor;3855;1938;1917
14;Córdoba;042;Montilla;22859;11353;11506
14;Córdoba;043;Montoro;9364;4616;4748
14;Córdoba;044;Monturque;1958;967;991
14;Córdoba;045;Moriles;3717;1866;1851
14;Córdoba;046;Nueva Carteya;5379;2732;2647
14;Córdoba;047;Obejo;2011;1048;963
14;Córdoba;048;Palenciana;1478;748;730
14;Córdoba;049;Palma del Río;21064;10456;10608
14;Córdoba;050;Pedro Abad;2837;1435;1402
14;Córdoba;051;Pedroche;1516;738;778
14;Córdoba;052;Peñarroya-Pueblonuevo;10695;5180;5515
14;Córdoba;053;Posadas;7325;3635;3690
14;Córdoba;054;Pozoblanco;17210;8371;8839
14;Córdoba;055;Priego de Córdoba;22408;10929;11479
14;Córdoba;056;Puente Genil;30048;14938;15110
14;Córdoba;057;Rambla, La;7493;3713;3780
14;Córdoba;058;Rute;9845;4892;4953
14;Córdoba;059;San Sebastián de los Ballesteros;808;406;402
14;Córdoba;061;Santa Eufemia;755;383;372
14;Córdoba;060;Santaella;4629;2327;2302
14;Córdoba;062;Torrecampo;1059;519;540
14;Córdoba;063;Valenzuela;1131;562;569
14;Córdoba;064;Valsequillo;356;168;188
14;Córdoba;065;Victoria, La;2271;1131;1140
14;Córdoba;066;Villa del Río;7104;3527;3577
14;Córdoba;067;Villafranca de Córdoba;4871;2486;2385
14;Córdoba;068;Villaharta;619;301;318
14;Córdoba;069;Villanueva de Córdoba;8729;4331;4398
14;Córdoba;070;Villanueva del Duque;1461;743;718
14;Córdoba;071;Villanueva del Rey;1046;513;533
14;Córdoba;072;Villaralto;1131;569;562
14;Córdoba;073;Villaviciosa de Córdoba;3229;1663;1566
14;Córdoba;074;Viso, El;2536;1265;1271
14;Córdoba;075;Zuheros;641;328;313
15;Coruña, A;001;Abegondo;5406;2655;2751
15;Coruña, A;002;Ames;31793;15236;16557
15;Coruña, A;003;Aranga;1849;964;885
15;Coruña, A;004;Ares;5732;2825;2907
15;Coruña, A;005;Arteixo;32262;15976;16286
15;Coruña, A;006;Arzúa;6041;3012;3029
15;Coruña, A;007;Baña, A;3450;1628;1822
15;Coruña, A;008;Bergondo;6633;3232;3401
15;Coruña, A;009;Betanzos;12959;6155;6804
15;Coruña, A;010;Boimorto;1985;1003;982
15;Coruña, A;011;Boiro;18838;9177;9661
15;Coruña, A;012;Boqueixón;4220;2091;2129
15;Coruña, A;013;Brión;7837;3773;4064
15;Coruña, A;014;Cabana de Bergantiños;4248;2054;2194
15;Coruña, A;015;Cabanas;3281;1606;1675
15;Coruña, A;016;Camariñas;5272;2577;2695
15;Coruña, A;017;Cambre;24648;12024;12624
15;Coruña, A;018;Capela, A;1232;612;620
15;Coruña, A;019;Carballo;31349;15342;16007
15;Coruña, A;901;Cariño;3838;1901;1937
15;Coruña, A;020;Carnota;3957;1871;2086
15;Coruña, A;021;Carral;6408;3151;3257
15;Coruña, A;022;Cedeira;6640;3292;3348
15;Coruña, A;023;Cee;7546;3605;3941
15;Coruña, A;024;Cerceda;5001;2457;2544
15;Coruña, A;025;Cerdido;1113;547;566
15;Coruña, A;027;Coirós;1824;906;918
15;Coruña, A;028;Corcubión;1589;769;820
15;Coruña, A;029;Coristanco;6074;2895;3179
15;Coruña, A;030;Coruña, A;245711;113900;131811
15;Coruña, A;031;Culleredo;30402;14685;15717
15;Coruña, A;032;Curtis;3983;1981;2002
15;Coruña, A;033;Dodro;2768;1344;1424
15;Coruña, A;034;Dumbría;2983;1434;1549
15;Coruña, A;035;Fene;12944;6170;6774
15;Coruña, A;036;Ferrol;66065;31027;35038
15;Coruña, A;037;Fisterra;4708;2380;2328
15;Coruña, A;038;Frades;2339;1162;1177
15;Coruña, A;039;Irixoa;1334;663;671
15;Coruña, A;041;Laracha, A;11347;5591;5756
15;Coruña, A;040;Laxe;3016;1515;1501
15;Coruña, A;042;Lousame;3338;1647;1691
15;Coruña, A;043;Malpica de Bergantiños;5391;2631;2760
15;Coruña, A;044;Mañón;1356;665;691
15;Coruña, A;045;Mazaricos;3885;1855;2030
15;Coruña, A;046;Melide;7406;3654;3752
15;Coruña, A;047;Mesía;2530;1260;1270
15;Coruña, A;048;Miño;6200;3082;3118
15;Coruña, A;049;Moeche;1226;586;640
15;Coruña, A;050;Monfero;1932;994;938
15;Coruña, A;051;Mugardos;5245;2541;2704
15;Coruña, A;053;Muros;8556;4123;4433
15;Coruña, A;052;Muxía;4657;2260;2397
15;Coruña, A;054;Narón;39080;18904;20176
15;Coruña, A;055;Neda;5079;2464;2615
15;Coruña, A;056;Negreira;6827;3302;3525
15;Coruña, A;057;Noia;14263;6839;7424
15;Coruña, A;058;Oleiros;36075;17381;18694
15;Coruña, A;059;Ordes;12674;6190;6484
15;Coruña, A;060;Oroso;7500;3708;3792
15;Coruña, A;061;Ortigueira;5671;2708;2963
15;Coruña, A;062;Outes;6282;3018;3264
15;Coruña, A;902;Oza-Cesuras;5101;2562;2539
15;Coruña, A;064;Paderne;2394;1173;1221
15;Coruña, A;065;Padrón;8384;4030;4354
15;Coruña, A;066;Pino, O;4641;2333;2308
15;Coruña, A;067;Pobra do Caramiñal, A;9338;4563;4775
15;Coruña, A;068;Ponteceso;5502;2756;2746
15;Coruña, A;069;Pontedeume;7777;3711;4066
15;Coruña, A;070;Pontes de García Rodríguez, As;10138;4934;5204
15;Coruña, A;071;Porto do Son;9171;4562;4609
15;Coruña, A;072;Rianxo;11033;5395;5638
15;Coruña, A;073;Ribeira;26886;13263;13623
15;Coruña, A;074;Rois;4512;2144;2368
15;Coruña, A;075;Sada;15841;7741;8100
15;Coruña, A;076;San Sadurniño;2822;1396;1426
15;Coruña, A;077;Santa Comba;9426;4553;4873
15;Coruña, A;078;Santiago de Compostela;97260;45179;52081
15;Coruña, A;079;Santiso;1584;816;768
15;Coruña, A;080;Sobrado;1758;909;849
15;Coruña, A;081;Somozas, As;1098;550;548
15;Coruña, A;082;Teo;18579;9127;9452
15;Coruña, A;083;Toques;1124;584;540
15;Coruña, A;084;Tordoia;3299;1558;1741
15;Coruña, A;085;Touro;3574;1780;1794
15;Coruña, A;086;Trazo;3113;1538;1575
15;Coruña, A;088;Val do Dubra;3876;1854;2022
15;Coruña, A;087;Valdoviño;6563;3181;3382
15;Coruña, A;089;Vedra;5036;2475;2561
15;Coruña, A;091;Vilarmaior;1226;627;599
15;Coruña, A;090;Vilasantar;1213;642;571
15;Coruña, A;092;Vimianzo;7057;3380;3677
15;Coruña, A;093;Zas;4472;2154;2318
16;Cuenca;001;Abia de la Obispalía;65;40;25
16;Cuenca;002;Acebrón, El;234;115;119
16;Cuenca;003;Alarcón;148;67;81
16;Cuenca;004;Albaladejo del Cuende;245;127;118
16;Cuenca;005;Albalate de las Nogueras;253;132;121
16;Cuenca;006;Albendea;121;57;64
16;Cuenca;007;Alberca de Záncara, La;1590;807;783
16;Cuenca;008;Alcalá de la Vega;93;55;38
16;Cuenca;009;Alcantud;51;28;23
16;Cuenca;010;Alcázar del Rey;152;78;74
16;Cuenca;011;Alcohujate;28;15;13
16;Cuenca;012;Alconchel de la Estrella;88;51;37
16;Cuenca;013;Algarra;26;13;13
16;Cuenca;014;Aliaguilla;642;331;311
16;Cuenca;015;Almarcha, La;365;201;164
16;Cuenca;016;Almendros;247;139;108
16;Cuenca;017;Almodóvar del Pinar;390;216;174
16;Cuenca;018;Almonacid del Marquesado;425;218;207
16;Cuenca;019;Altarejos;190;101;89
16;Cuenca;020;Arandilla del Arroyo;7;3;4
16;Cuenca;905;Arcas;1716;866;850
16;Cuenca;022;Arcos de la Sierra;83;47;36
16;Cuenca;024;Arguisuelas;136;74;62
16;Cuenca;025;Arrancacepas;25;13;12
16;Cuenca;026;Atalaya del Cañavate;112;58;54
16;Cuenca;027;Barajas de Melo;932;491;441
16;Cuenca;029;Barchín del Hoyo;89;57;32
16;Cuenca;030;Bascuñana de San Pedro;18;15;3
16;Cuenca;031;Beamud;37;18;19
16;Cuenca;032;Belinchón;334;173;161
16;Cuenca;033;Belmonte;1903;954;949
16;Cuenca;034;Belmontejo;160;92;68
16;Cuenca;035;Beteta;262;125;137
16;Cuenca;036;Boniches;146;71;75
16;Cuenca;038;Buciegas;36;25;11
16;Cuenca;039;Buenache de Alarcón;459;239;220
16;Cuenca;040;Buenache de la Sierra;97;56;41
16;Cuenca;041;Buendía;400;213;187
16;Cuenca;042;Campillo de Altobuey;1322;655;667
16;Cuenca;043;Campillos-Paravientos;105;60;45
16;Cuenca;044;Campillos-Sierra;38;17;21
16;Cuenca;901;Campos del Paraíso;737;374;363
16;Cuenca;045;Canalejas del Arroyo;186;102;84
16;Cuenca;046;Cañada del Hoyo;243;125;118
16;Cuenca;047;Cañada Juncosa;240;130;110
16;Cuenca;048;Cañamares;466;254;212
16;Cuenca;049;Cañavate, El;146;73;73
16;Cuenca;050;Cañaveras;258;127;131
16;Cuenca;051;Cañaveruelas;132;67;65
16;Cuenca;052;Cañete;739;377;362
16;Cuenca;053;Cañizares;439;240;199
16;Cuenca;055;Carboneras de Guadazaón;811;417;394
16;Cuenca;056;Cardenete;496;267;229
16;Cuenca;057;Carrascosa;70;42;28
16;Cuenca;058;Carrascosa de Haro;106;56;50
16;Cuenca;060;Casas de Benítez;852;424;428
16;Cuenca;061;Casas de Fernando Alonso;1169;608;561
16;Cuenca;062;Casas de Garcimolina;29;19;10
16;Cuenca;063;Casas de Guijarro;117;63;54
16;Cuenca;064;Casas de Haro;823;437;386
16;Cuenca;065;Casas de los Pinos;440;218;222
16;Cuenca;066;Casasimarro;3084;1590;1494
16;Cuenca;067;Castejón;144;79;65
16;Cuenca;068;Castillejo de Iniesta;159;85;74
16;Cuenca;070;Castillejo-Sierra;28;15;13
16;Cuenca;072;Castillo de Garcimuñoz;134;78;56
16;Cuenca;071;Castillo-Albaráñez;22;10;12
16;Cuenca;073;Cervera del Llano;221;116;105
16;Cuenca;023;Chillarón de Cuenca;617;322;295
16;Cuenca;081;Chumillas;57;32;25
16;Cuenca;074;Cierva, La;28;16;12
16;Cuenca;078;Cuenca;54690;26049;28641
16;Cuenca;079;Cueva del Hierro;29;21;8
16;Cuenca;082;Enguídanos;317;167;150
16;Cuenca;083;Fresneda de Altarejos;40;20;20
16;Cuenca;084;Fresneda de la Sierra;48;28;20
16;Cuenca;085;Frontera, La;155;82;73
16;Cuenca;086;Fuente de Pedro Naharro;1205;624;581
16;Cuenca;087;Fuentelespino de Haro;274;142;132
16;Cuenca;088;Fuentelespino de Moya;109;60;49
16;Cuenca;904;Fuentenava de Jábaga;513;268;245
16;Cuenca;089;Fuentes;455;241;214
16;Cuenca;091;Fuertescusa;63;35;28
16;Cuenca;092;Gabaldón;183;111;72
16;Cuenca;093;Garaballa;59;33;26
16;Cuenca;094;Gascueña;153;86;67
16;Cuenca;095;Graja de Campalbo;91;50;41
16;Cuenca;096;Graja de Iniesta;361;185;176
16;Cuenca;097;Henarejos;139;73;66
16;Cuenca;098;Herrumblar, El;664;338;326
16;Cuenca;099;Hinojosa, La;188;96;92
16;Cuenca;100;Hinojosos, Los;771;380;391
16;Cuenca;101;Hito, El;141;77;64
16;Cuenca;102;Honrubia;1566;786;780
16;Cuenca;103;Hontanaya;253;143;110
16;Cuenca;104;Hontecillas;61;33;28
16;Cuenca;106;Horcajo de Santiago;3493;1770;1723
16;Cuenca;107;Huélamo;99;55;44
16;Cuenca;108;Huelves;57;30;27
16;Cuenca;109;Huérguina;44;24;20
16;Cuenca;110;Huerta de la Obispalía;114;67;47
16;Cuenca;111;Huerta del Marquesado;194;108;86
16;Cuenca;112;Huete;1765;913;852
16;Cuenca;113;Iniesta;4305;2129;2176
16;Cuenca;115;Laguna del Marquesado;50;28;22
16;Cuenca;116;Lagunaseca;77;45;32
16;Cuenca;117;Landete;1234;633;601
16;Cuenca;118;Ledaña;1563;772;791
16;Cuenca;119;Leganiel;190;98;92
16;Cuenca;121;Majadas, Las;241;126;115
16;Cuenca;122;Mariana;304;157;147
16;Cuenca;123;Masegosa;64;37;27
16;Cuenca;124;Mesas, Las;2336;1188;1148
16;Cuenca;125;Minglanilla;2221;1137;1084
16;Cuenca;126;Mira;905;462;443
16;Cuenca;128;Monreal del Llano;56;31;25
16;Cuenca;129;Montalbanejo;103;54;49
16;Cuenca;130;Montalbo;643;337;306
16;Cuenca;131;Monteagudo de las Salinas;129;75;54
16;Cuenca;132;Mota de Altarejos;34;22;12
16;Cuenca;133;Mota del Cuervo;5990;2993;2997
16;Cuenca;134;Motilla del Palancar;5869;2908;2961
16;Cuenca;135;Moya;139;84;55
16;Cuenca;137;Narboneta;37;19;18
16;Cuenca;139;Olivares de Júcar;325;169;156
16;Cuenca;140;Olmeda de la Cuesta;20;11;9
16;Cuenca;141;Olmeda del Rey;132;67;65
16;Cuenca;142;Olmedilla de Alarcón;149;85;64
16;Cuenca;143;Olmedilla de Eliz;15;10;5
16;Cuenca;145;Osa de la Vega;479;249;230
16;Cuenca;146;Pajarón;82;39;43
16;Cuenca;147;Pajaroncillo;65;40;25
16;Cuenca;148;Palomares del Campo;602;308;294
16;Cuenca;149;Palomera;171;85;86
16;Cuenca;150;Paracuellos;94;50;44
16;Cuenca;151;Paredes;66;37;29
16;Cuenca;152;Parra de las Vegas, La;33;23;10
16;Cuenca;153;Pedernoso, El;1124;561;563
16;Cuenca;154;Pedroñeras, Las;6638;3406;3232
16;Cuenca;155;Peral, El;632;353;279
16;Cuenca;156;Peraleja, La;97;60;37
16;Cuenca;157;Pesquera, La;215;119;96
16;Cuenca;158;Picazo, El;666;336;330
16;Cuenca;159;Pinarejo;212;109;103
16;Cuenca;160;Pineda de Gigüela;60;37;23
16;Cuenca;161;Piqueras del Castillo;48;27;21
16;Cuenca;162;Portalrubio de Guadamejud;22;10;12
16;Cuenca;163;Portilla;59;32;27
16;Cuenca;165;Poyatos;56;29;27
16;Cuenca;166;Pozoamargo;292;154;138
16;Cuenca;908;Pozorrubielos de la Mancha;180;92;88
16;Cuenca;167;Pozorrubio de Santiago;323;155;168
16;Cuenca;169;Pozuelo, El;49;31;18
16;Cuenca;170;Priego;896;455;441
16;Cuenca;171;Provencio, El;2437;1200;1237
16;Cuenca;172;Puebla de Almenara;384;199;185
16;Cuenca;174;Puebla del Salvador;181;100;81
16;Cuenca;175;Quintanar del Rey;7586;3901;3685
16;Cuenca;176;Rada de Haro;44;23;21
16;Cuenca;177;Reíllo;118;62;56
16;Cuenca;181;Rozalén del Monte;67;31;36
16;Cuenca;185;Saceda-Trasierra;41;30;11
16;Cuenca;186;Saelices;483;252;231
16;Cuenca;187;Salinas del Manzano;68;40;28
16;Cuenca;188;Salmeroncillos;102;58;44
16;Cuenca;189;Salvacañete;303;158;145
16;Cuenca;190;San Clemente;6988;3511;3477
16;Cuenca;191;San Lorenzo de la Parrilla;1042;524;518
16;Cuenca;192;San Martín de Boniches;44;23;21
16;Cuenca;193;San Pedro Palmiches;57;32;25
16;Cuenca;194;Santa Cruz de Moya;218;117;101
16;Cuenca;196;Santa María de los Llanos;676;352;324
16;Cuenca;195;Santa María del Campo Rus;571;293;278
16;Cuenca;197;Santa María del Val;67;39;28
16;Cuenca;198;Sisante;1642;826;816
16;Cuenca;199;Solera de Gabaldón;28;15;13
16;Cuenca;909;Sotorribas;732;378;354
16;Cuenca;202;Talayuelas;878;467;411
16;Cuenca;203;Tarancón;15271;7550;7721
16;Cuenca;204;Tébar;286;146;140
16;Cuenca;205;Tejadillos;118;57;61
16;Cuenca;206;Tinajas;201;110;91
16;Cuenca;209;Torralba;112;67;45
16;Cuenca;211;Torrejoncillo del Rey;341;180;161
16;Cuenca;212;Torrubia del Campo;257;129;128
16;Cuenca;213;Torrubia del Castillo;38;24;14
16;Cuenca;215;Tragacete;249;139;110
16;Cuenca;216;Tresjuncos;293;155;138
16;Cuenca;217;Tribaldos;107;57;50
16;Cuenca;218;Uclés;222;117;105
16;Cuenca;219;Uña;82;43;39
16;Cuenca;906;Valdecolmenas, Los;72;47;25
16;Cuenca;224;Valdemeca;84;47;37
16;Cuenca;225;Valdemorillo de la Sierra;59;35;24
16;Cuenca;227;Valdemoro-Sierra;110;65;45
16;Cuenca;228;Valdeolivas;202;125;77
16;Cuenca;902;Valdetórtola;133;75;58
16;Cuenca;903;Valeras, Las;1496;789;707
16;Cuenca;231;Valhermoso de la Fuente;57;30;27
16;Cuenca;173;Valle de Altomira, El;211;117;94
16;Cuenca;234;Valsalobre;23;12;11
16;Cuenca;236;Valverde de Júcar;1082;534;548
16;Cuenca;237;Valverdejo;93;51;42
16;Cuenca;238;Vara de Rey;496;254;242
16;Cuenca;239;Vega del Codorno;129;80;49
16;Cuenca;240;Vellisca;102;59;43
16;Cuenca;242;Villaconejos de Trabaque;344;172;172
16;Cuenca;243;Villaescusa de Haro;470;239;231
16;Cuenca;244;Villagarcía del Llano;759;383;376
16;Cuenca;245;Villalba de la Sierra;456;225;231
16;Cuenca;246;Villalba del Rey;516;282;234
16;Cuenca;247;Villalgordo del Marquesado;80;42;38
16;Cuenca;248;Villalpardo;1018;504;514
16;Cuenca;249;Villamayor de Santiago;2481;1258;1223
16;Cuenca;250;Villanueva de Guadamejud;65;39;26
16;Cuenca;251;Villanueva de la Jara;2249;1133;1116
16;Cuenca;253;Villar de Cañas;374;204;170
16;Cuenca;254;Villar de Domingo García;220;109;111
16;Cuenca;255;Villar de la Encina;154;84;70
16;Cuenca;263;Villar de Olalla;1270;682;588
16;Cuenca;258;Villar del Humo;184;102;82
16;Cuenca;259;Villar del Infantado;43;23;20
16;Cuenca;910;Villar y Velasco;77;44;33
16;Cuenca;264;Villarejo de Fuentes;429;215;214
16;Cuenca;265;Villarejo de la Peñuela;20;9;11
16;Cuenca;266;Villarejo-Periesteban;380;190;190
16;Cuenca;269;Villares del Saz;443;226;217
16;Cuenca;270;Villarrubio;194;109;85
16;Cuenca;271;Villarta;793;393;400
16;Cuenca;272;Villas de la Ventosa;211;123;88
16;Cuenca;273;Villaverde y Pasaconsol;332;176;156
16;Cuenca;274;Víllora;114;60;54
16;Cuenca;275;Vindel;11;7;4
16;Cuenca;276;Yémeda;21;13;8
16;Cuenca;277;Zafra de Záncara;122;68;54
16;Cuenca;278;Zafrilla;58;29;29
16;Cuenca;279;Zarza de Tajo;239;138;101
16;Cuenca;280;Zarzuela;170;91;79
20;Gipuzkoa;001;Abaltzisketa;333;181;152
20;Gipuzkoa;002;Aduna;469;253;216
20;Gipuzkoa;016;Aia;2054;1092;962
20;Gipuzkoa;003;Aizarnazabal;772;391;381
20;Gipuzkoa;004;Albiztur;304;159;145
20;Gipuzkoa;005;Alegia;1722;890;832
20;Gipuzkoa;006;Alkiza;367;178;189
20;Gipuzkoa;906;Altzaga;183;90;93
20;Gipuzkoa;007;Altzo;435;226;209
20;Gipuzkoa;008;Amezketa;921;497;424
20;Gipuzkoa;009;Andoain;14637;7248;7389
20;Gipuzkoa;010;Anoeta;2090;1088;1002
20;Gipuzkoa;011;Antzuola;2126;1059;1067
20;Gipuzkoa;012;Arama;200;99;101
20;Gipuzkoa;013;Aretxabaleta;7128;3577;3551
20;Gipuzkoa;055;Arrasate/Mondragón;22001;10814;11187
20;Gipuzkoa;014;Asteasu;1551;808;743
20;Gipuzkoa;903;Astigarraga;6532;3312;3220
20;Gipuzkoa;015;Ataun;1693;879;814
20;Gipuzkoa;017;Azkoitia;11633;5783;5850
20;Gipuzkoa;018;Azpeitia;14936;7468;7468
20;Gipuzkoa;904;Baliarrain;138;74;64
20;Gipuzkoa;019;Beasain;13880;6976;6904
20;Gipuzkoa;020;Beizama;143;86;57
20;Gipuzkoa;021;Belauntza;241;125;116
20;Gipuzkoa;022;Berastegi;1076;555;521
20;Gipuzkoa;074;Bergara;14637;7260;7377
20;Gipuzkoa;023;Berrobi;603;315;288
20;Gipuzkoa;024;Bidania-Goiatz;520;284;236
20;Gipuzkoa;029;Deba;5459;2711;2748
20;Gipuzkoa;069;Donostia/San Sebastián;187415;88306;99109
20;Gipuzkoa;030;Eibar;27522;13391;14131
20;Gipuzkoa;031;Elduain;250;125;125
20;Gipuzkoa;033;Elgeta;1136;581;555
20;Gipuzkoa;032;Elgoibar;11613;5739;5874
20;Gipuzkoa;067;Errenteria;39471;19110;20361
20;Gipuzkoa;066;Errezil;585;307;278
20;Gipuzkoa;034;Eskoriatza;4065;2033;2032
20;Gipuzkoa;035;Ezkio-Itsaso;611;321;290
20;Gipuzkoa;038;Gabiria;488;258;230
20;Gipuzkoa;037;Gaintza;128;75;53
20;Gipuzkoa;907;Gaztelu;152;82;70
20;Gipuzkoa;039;Getaria;2821;1430;1391
20;Gipuzkoa;040;Hernani;20354;9964;10390
20;Gipuzkoa;041;Hernialde;303;159;144
20;Gipuzkoa;036;Hondarribia;16828;8370;8458
20;Gipuzkoa;042;Ibarra;4199;2094;2105
20;Gipuzkoa;043;Idiazabal;2312;1174;1138
20;Gipuzkoa;044;Ikaztegieta;498;251;247
20;Gipuzkoa;045;Irun;62401;30494;31907
20;Gipuzkoa;046;Irura;1852;962;890
20;Gipuzkoa;047;Itsasondo;658;343;315
20;Gipuzkoa;048;Larraul;251;138;113
20;Gipuzkoa;902;Lasarte-Oria;18380;8899;9481
20;Gipuzkoa;049;Lazkao;5742;2887;2855
20;Gipuzkoa;050;Leaburu;372;199;173
20;Gipuzkoa;051;Legazpi;8371;4227;4144
20;Gipuzkoa;052;Legorreta;1417;716;701
20;Gipuzkoa;068;Leintz-Gatzaga;234;126;108
20;Gipuzkoa;053;Lezo;6122;3051;3071
20;Gipuzkoa;054;Lizartza;603;312;291
20;Gipuzkoa;901;Mendaro;1999;1002;997
20;Gipuzkoa;057;Mutiloa;249;136;113
20;Gipuzkoa;056;Mutriku;5333;2688;2645
20;Gipuzkoa;063;Oiartzun;10293;5081;5212
20;Gipuzkoa;058;Olaberria;953;480;473
20;Gipuzkoa;059;Oñati;11380;5617;5763
20;Gipuzkoa;076;Ordizia;10394;5151;5243
20;Gipuzkoa;905;Orendain;218;112;106
20;Gipuzkoa;060;Orexa;121;67;54
20;Gipuzkoa;061;Orio;6022;3020;3002
20;Gipuzkoa;062;Ormaiztegi;1276;641;635
20;Gipuzkoa;064;Pasaia;16156;7794;8362
20;Gipuzkoa;070;Segura;1467;742;725
20;Gipuzkoa;065;Soraluze-Placencia de las Armas;3883;1945;1938
20;Gipuzkoa;071;Tolosa;19667;9502;10165
20;Gipuzkoa;072;Urnieta;6168;3088;3080
20;Gipuzkoa;077;Urretxu;6756;3327;3429
20;Gipuzkoa;073;Usurbil;6174;3090;3084
20;Gipuzkoa;075;Villabona;5867;2939;2928
20;Gipuzkoa;078;Zaldibia;1613;824;789
20;Gipuzkoa;079;Zarautz;23323;11357;11966
20;Gipuzkoa;025;Zegama;1528;773;755
20;Gipuzkoa;026;Zerain;259;124;135
20;Gipuzkoa;027;Zestoa;3711;1939;1772
20;Gipuzkoa;028;Zizurkil;3002;1512;1490
20;Gipuzkoa;081;Zumaia;10098;5019;5079
20;Gipuzkoa;080;Zumarraga;9728;4791;4937
17;Girona;001;Agullana;831;411;420
17;Girona;002;Aiguaviva;756;383;373
17;Girona;003;Albanyà;157;80;77
17;Girona;004;Albons;776;401;375
17;Girona;006;Alp;1580;828;752
17;Girona;007;Amer;2298;1122;1176
17;Girona;008;Anglès;5599;2780;2819
17;Girona;009;Arbúcies;6556;3390;3166
17;Girona;010;Argelaguer;397;205;192
17;Girona;011;Armentera, L';930;461;469
17;Girona;012;Avinyonet de Puigventós;1610;796;814
17;Girona;015;Banyoles;19826;9873;9953
17;Girona;016;Bàscara;1004;520;484
17;Girona;013;Begur;3925;1964;1961
17;Girona;018;Bellcaire d'Empordà;693;336;357
17;Girona;019;Besalú;2492;1170;1322
17;Girona;020;Bescanó;4960;2505;2455
17;Girona;021;Beuda;190;100;90
17;Girona;022;Bisbal d'Empordà, La;10974;5446;5528
17;Girona;234;Biure;232;118;114
17;Girona;023;Blanes;39028;19356;19672
17;Girona;029;Boadella i les Escaules;252;130;122
17;Girona;024;Bolvir;369;191;178
17;Girona;025;Bordils;1779;887;892
17;Girona;026;Borrassà;714;374;340
17;Girona;027;Breda;3740;1836;1904
17;Girona;028;Brunyola i Sant Martí Sapresa;383;195;188
17;Girona;031;Cabanelles;279;154;125
17;Girona;030;Cabanes;948;500;448
17;Girona;032;Cadaqués;2712;1322;1390
17;Girona;033;Caldes de Malavella;7641;3828;3813
17;Girona;034;Calonge i Sant Antoni;11092;5571;5521
17;Girona;035;Camós;693;341;352
17;Girona;036;Campdevànol;3223;1566;1657
17;Girona;037;Campelles;139;71;68
17;Girona;038;Campllong;547;272;275
17;Girona;039;Camprodon;2281;1117;1164
17;Girona;040;Canet d'Adri;723;371;352
17;Girona;041;Cantallops;313;153;160
17;Girona;042;Capmany;613;307;306
17;Girona;044;Cassà de la Selva;10380;5301;5079
17;Girona;046;Castellfollit de la Roca;961;493;468
17;Girona;047;Castelló d'Empúries;10906;5508;5398
17;Girona;048;Castell-Platja d'Aro;10860;5357;5503
17;Girona;189;Cellera de Ter, La;1946;965;981
17;Girona;049;Celrà;5452;2722;2730
17;Girona;050;Cervià de Ter;968;492;476
17;Girona;051;Cistella;282;138;144
17;Girona;054;Colera;448;223;225
17;Girona;055;Colomers;176;87;89
17;Girona;057;Corçà;1267;646;621
17;Girona;056;Cornellà del Terri;2364;1197;1167
17;Girona;058;Crespià;246;127;119
17;Girona;901;Cruïlles, Monells i Sant Sadurní de l'Heura;1279;640;639
17;Girona;060;Darnius;546;273;273
17;Girona;061;Das;253;131;122
17;Girona;062;Escala, L';10339;5267;5072
17;Girona;063;Espinelves;215;110;105
17;Girona;064;Espolla;416;203;213
17;Girona;065;Esponellà;438;224;214
17;Girona;005;Far d'Empordà, El;599;305;294
17;Girona;066;Figueres;46654;23092;23562
17;Girona;067;Flaçà;1093;528;565
17;Girona;068;Foixà;297;150;147
17;Girona;069;Fontanals de Cerdanya;444;220;224
17;Girona;070;Fontanilles;139;80;59
17;Girona;071;Fontcoberta;1468;738;730
17;Girona;902;Forallac;1687;828;859
17;Girona;073;Fornells de la Selva;2650;1322;1328
17;Girona;074;Fortià;763;389;374
17;Girona;075;Garrigàs;437;231;206
17;Girona;076;Garrigoles;162;84;78
17;Girona;077;Garriguella;855;421;434
17;Girona;078;Ger;448;222;226
17;Girona;079;Girona;101852;48931;52921
17;Girona;080;Gombrèn;188;96;92
17;Girona;081;Gualta;397;229;168
17;Girona;082;Guils de Cerdanya;537;288;249
17;Girona;083;Hostalric;4221;2130;2091
17;Girona;084;Isòvol;281;161;120
17;Girona;085;Jafre;380;206;174
17;Girona;086;Jonquera, La;3290;1637;1653
17;Girona;087;Juià;323;174;149
17;Girona;088;Lladó;818;398;420
17;Girona;089;Llagostera;8453;4303;4150
17;Girona;090;Llambilles;696;359;337
17;Girona;091;Llanars;505;259;246
17;Girona;092;Llançà;4836;2394;2442
17;Girona;093;Llers;1239;617;622
17;Girona;094;Llívia;1417;748;669
17;Girona;095;Lloret de Mar;38373;19528;18845
17;Girona;096;Llosses, Les;218;121;97
17;Girona;102;Maçanet de Cabrenys;688;340;348
17;Girona;103;Maçanet de la Selva;7006;3598;3408
17;Girona;097;Madremanya;283;138;145
17;Girona;098;Maià de Montcal;449;251;198
17;Girona;100;Masarac;288;150;138
17;Girona;101;Massanes;761;405;356
17;Girona;099;Meranges;104;58;46
17;Girona;105;Mieres;318;160;158
17;Girona;106;Mollet de Peralada;189;96;93
17;Girona;107;Molló;337;162;175
17;Girona;109;Montagut i Oix;916;475;441
17;Girona;110;Mont-ras;1679;846;833
17;Girona;111;Navata;1381;671;710
17;Girona;112;Ogassa;234;130;104
17;Girona;114;Olot;35228;17569;17659
17;Girona;115;Ordis;371;199;172
17;Girona;116;Osor;428;227;201
17;Girona;117;Palafrugell;22974;11377;11597
17;Girona;118;Palamós;17910;8766;9144
17;Girona;119;Palau de Santa Eulàlia;91;52;39
17;Girona;121;Palau-sator;310;166;144
17;Girona;120;Palau-saverdera;1476;741;735
17;Girona;123;Palol de Revardit;455;228;227
17;Girona;124;Pals;2411;1222;1189
17;Girona;125;Pardines;162;89;73
17;Girona;126;Parlavà;394;199;195
17;Girona;128;Pau;560;285;275
17;Girona;129;Pedret i Marzà;198;101;97
17;Girona;130;Pera, La;446;221;225
17;Girona;132;Peralada;1850;906;944
17;Girona;133;Planes d'Hostoles, Les;1683;851;832
17;Girona;134;Planoles;288;157;131
17;Girona;135;Pont de Molins;529;267;262
17;Girona;136;Pontós;266;141;125
17;Girona;137;Porqueres;4621;2288;2333
17;Girona;140;Port de la Selva, El;970;501;469
17;Girona;138;Portbou;1075;528;547
17;Girona;139;Preses, Les;1788;890;898
17;Girona;141;Puigcerdà;9258;4585;4673
17;Girona;142;Quart;3724;1855;1869
17;Girona;043;Queralbs;191;104;87
17;Girona;143;Rabós;178;89;89
17;Girona;144;Regencós;269;141;128
17;Girona;145;Ribes de Freser;1754;882;872
17;Girona;146;Riells i Viabrea;4124;2113;2011
17;Girona;147;Ripoll;10686;5273;5413
17;Girona;148;Riudarenes;2182;1125;1057
17;Girona;149;Riudaura;478;232;246
17;Girona;150;Riudellots de la Selva;2076;1053;1023
17;Girona;151;Riumors;258;126;132
17;Girona;152;Roses;19550;9862;9688
17;Girona;153;Rupià;272;138;134
17;Girona;154;Sales de Llierca;154;77;77
17;Girona;155;Salt;31362;16454;14908
17;Girona;157;Sant Andreu Salou;155;79;76
17;Girona;183;Sant Aniol de Finestres;341;177;164
17;Girona;158;Sant Climent Sescebes;626;364;262
17;Girona;159;Sant Feliu de Buixalleu;783;410;373
17;Girona;160;Sant Feliu de Guíxols;21925;10802;11123
17;Girona;161;Sant Feliu de Pallerols;1371;667;704
17;Girona;162;Sant Ferriol;243;124;119
17;Girona;163;Sant Gregori;3817;1959;1858
17;Girona;164;Sant Hilari Sacalm;5627;2843;2784
17;Girona;165;Sant Jaume de Llierca;865;416;449
17;Girona;167;Sant Joan de les Abadesses;3232;1604;1628
17;Girona;168;Sant Joan de Mollet;507;248;259
17;Girona;185;Sant Joan les Fonts;3006;1541;1465
17;Girona;166;Sant Jordi Desvalls;761;380;381
17;Girona;169;Sant Julià de Ramis;3515;1780;1735
17;Girona;903;Sant Julià del Llor i Bonmatí;1286;651;635
17;Girona;171;Sant Llorenç de la Muga;264;135;129
17;Girona;172;Sant Martí de Llémena;633;330;303
17;Girona;173;Sant Martí Vell;252;131;121
17;Girona;174;Sant Miquel de Campmajor;231;127;104
17;Girona;175;Sant Miquel de Fluvià;764;397;367
17;Girona;176;Sant Mori;177;90;87
17;Girona;177;Sant Pau de Segúries;697;347;350
17;Girona;178;Sant Pere Pescador;2042;1084;958
17;Girona;180;Santa Coloma de Farners;13143;6621;6522
17;Girona;181;Santa Cristina d'Aro;5223;2624;2599
17;Girona;182;Santa Llogaia d'Àlguema;370;189;181
17;Girona;184;Santa Pau;1565;792;773
17;Girona;186;Sarrià de Ter;5170;2530;2640
17;Girona;187;Saus, Camallera i Llampaies;837;424;413
17;Girona;188;Selva de Mar, La;196;108;88
17;Girona;190;Serinyà;1136;576;560
17;Girona;191;Serra de Daró;221;122;99
17;Girona;192;Setcases;177;98;79
17;Girona;193;Sils;6093;3108;2985
17;Girona;052;Siurana;168;84;84
17;Girona;194;Susqueda;101;60;41
17;Girona;195;Tallada d'Empordà, La;463;241;222
17;Girona;196;Terrades;329;162;167
17;Girona;197;Torrent;175;92;83
17;Girona;198;Torroella de Fluvià;694;354;340
17;Girona;199;Torroella de Montgrí;11645;5900;5745
17;Girona;200;Tortellà;809;393;416
17;Girona;201;Toses;171;102;69
17;Girona;202;Tossa de Mar;5683;2861;2822
17;Girona;204;Ullà;1153;632;521
17;Girona;205;Ullastret;290;140;150
17;Girona;203;Ultramort;223;118;105
17;Girona;206;Urús;189;93;96
17;Girona;014;Vajol, La;89;48;41
17;Girona;208;Vall de Bianya, La;1264;639;625
17;Girona;207;Vall d'en Bas, La;3072;1553;1519
17;Girona;170;Vallfogona de Ripollès;206;109;97
17;Girona;209;Vall-llobrega;899;446;453
17;Girona;210;Ventalló;859;438;421
17;Girona;211;Verges;1171;572;599
17;Girona;212;Vidrà;167;83;84
17;Girona;213;Vidreres;7797;4048;3749
17;Girona;214;Vilabertran;979;489;490
17;Girona;215;Vilablareix;2897;1438;1459
17;Girona;217;Viladamat;468;241;227
17;Girona;216;Viladasens;200;107;93
17;Girona;218;Vilademuls;815;424;391
17;Girona;220;Viladrau;1040;509;531
17;Girona;221;Vilafant;5394;2636;2758
17;Girona;223;Vilajuïga;1104;549;555
17;Girona;224;Vilallonga de Ter;398;212;186
17;Girona;225;Vilamacolum;348;193;155
17;Girona;226;Vilamalla;1181;586;595
17;Girona;227;Vilamaniscle;200;116;84
17;Girona;228;Vilanant;392;197;195
17;Girona;230;Vila-sacra;760;372;388
17;Girona;222;Vilaür;157;81;76
17;Girona;233;Vilobí d'Onyar;3291;1711;1580
17;Girona;232;Vilopriu;202;107;95
18;Granada;001;Agrón;274;134;140
18;Granada;002;Alamedilla;574;288;286
18;Granada;003;Albolote;18808;9304;9504
18;Granada;004;Albondón;728;408;320
18;Granada;005;Albuñán;406;208;198
18;Granada;006;Albuñol;7233;3952;3281
18;Granada;007;Albuñuelas;821;408;413
18;Granada;010;Aldeire;615;322;293
18;Granada;011;Alfacar;5400;2751;2649
18;Granada;012;Algarinejo;2520;1290;1230
18;Granada;013;Alhama de Granada;5979;3204;2775
18;Granada;014;Alhendín;9349;4721;4628
18;Granada;015;Alicún de Ortega;480;238;242
18;Granada;016;Almegíjar;365;184;181
18;Granada;017;Almuñécar;26514;13079;13435
18;Granada;904;Alpujarra de la Sierra;989;563;426
18;Granada;018;Alquife;601;304;297
18;Granada;020;Arenas del Rey;666;366;300
18;Granada;021;Armilla;24174;11987;12187
18;Granada;022;Atarfe;18706;9320;9386
18;Granada;023;Baza;20412;10137;10275
18;Granada;024;Beas de Granada;977;519;458
18;Granada;025;Beas de Guadix;329;169;160
18;Granada;027;Benalúa;3318;1644;1674
18;Granada;028;Benalúa de las Villas;1066;556;510
18;Granada;029;Benamaurel;2293;1157;1136
18;Granada;030;Bérchules;716;386;330
18;Granada;032;Bubión;296;150;146
18;Granada;033;Busquístar;289;149;140
18;Granada;034;Cacín;569;289;280
18;Granada;035;Cádiar;1453;766;687
18;Granada;036;Cájar;5129;2468;2661
18;Granada;114;Calahorra, La;673;343;330
18;Granada;037;Calicasas;617;306;311
18;Granada;038;Campotéjar;1237;631;606
18;Granada;039;Caniles;4047;2076;1971
18;Granada;040;Cáñar;350;190;160
18;Granada;042;Capileira;554;277;277
18;Granada;043;Carataunas;194;102;92
18;Granada;044;Cástaras;249;145;104
18;Granada;045;Castilléjar;1318;678;640
18;Granada;046;Castril;2070;1076;994
18;Granada;047;Cenes de la Vega;8002;3999;4003
18;Granada;059;Chauchina;5565;2754;2811
18;Granada;061;Chimeneas;1257;657;600
18;Granada;062;Churriana de la Vega;15200;7531;7669
18;Granada;048;Cijuela;3322;1700;1622
18;Granada;049;Cogollos de Guadix;673;375;298
18;Granada;050;Cogollos de la Vega;2031;1018;1013
18;Granada;051;Colomera;1309;677;632
18;Granada;053;Cortes de Baza;1869;931;938
18;Granada;054;Cortes y Graena;996;528;468
18;Granada;912;Cuevas del Campo;1735;873;862
18;Granada;056;Cúllar;4129;2054;2075
18;Granada;057;Cúllar Vega;7429;3779;3650
18;Granada;063;Darro;1599;814;785
18;Granada;064;Dehesas de Guadix;419;206;213
18;Granada;065;Dehesas Viejas;705;363;342
18;Granada;066;Deifontes;2627;1325;1302
18;Granada;067;Diezma;764;402;362
18;Granada;068;Dílar;2054;1032;1022
18;Granada;069;Dólar;622;333;289
18;Granada;915;Domingo Pérez de Granada;890;464;426
18;Granada;070;Dúdar;330;173;157
18;Granada;071;Dúrcal;7015;3482;3533
18;Granada;072;Escúzar;791;408;383
18;Granada;074;Ferreira;299;157;142
18;Granada;076;Fonelas;978;505;473
18;Granada;077;Fornes;555;280;275
18;Granada;078;Freila;918;472;446
18;Granada;079;Fuente Vaqueros;4406;2210;2196
18;Granada;905;Gabias, Las;21115;10738;10377
18;Granada;082;Galera;1075;541;534
18;Granada;083;Gobernador;233;116;117
18;Granada;084;Gójar;5795;2947;2848
18;Granada;085;Gor;733;382;351
18;Granada;086;Gorafe;381;195;186
18;Granada;087;Granada;232462;107555;124907
18;Granada;088;Guadahortuna;1935;992;943
18;Granada;089;Guadix;18422;9120;9302
18;Granada;906;Guájares, Los;1057;556;501
18;Granada;093;Gualchos;5193;2794;2399
18;Granada;094;Güéjar Sierra;2820;1516;1304
18;Granada;095;Güevéjar;2595;1360;1235
18;Granada;096;Huélago;403;208;195
18;Granada;097;Huéneja;1184;667;517
18;Granada;098;Huéscar;7253;3586;3667
18;Granada;099;Huétor de Santillán;1877;964;913
18;Granada;100;Huétor Tájar;10352;5204;5148
18;Granada;101;Huétor Vega;12039;6043;5996
18;Granada;102;Íllora;10054;5057;4997
18;Granada;103;Ítrabo;988;496;492
18;Granada;105;Iznalloz;5134;2641;2493
18;Granada;106;Játar;614;339;275
18;Granada;107;Jayena;1060;550;510
18;Granada;108;Jérez del Marquesado;968;499;469
18;Granada;109;Jete;919;492;427
18;Granada;111;Jun;3833;1958;1875
18;Granada;112;Juviles;153;76;77
18;Granada;115;Láchar;3471;1782;1689
18;Granada;116;Lanjarón;3507;1757;1750
18;Granada;117;Lanteira;588;316;272
18;Granada;119;Lecrín;2134;1076;1058
18;Granada;120;Lentegí;326;169;157
18;Granada;121;Lobras;145;75;70
18;Granada;122;Loja;20342;10117;10225
18;Granada;123;Lugros;323;171;152
18;Granada;124;Lújar;488;263;225
18;Granada;126;Malahá, La;1781;897;884
18;Granada;127;Maracena;22116;10858;11258
18;Granada;128;Marchal;417;196;221
18;Granada;132;Moclín;3651;1821;1830
18;Granada;133;Molvízar;2794;1426;1368
18;Granada;134;Monachil;7939;4094;3845
18;Granada;135;Montefrío;5433;2754;2679
18;Granada;136;Montejícar;2113;1087;1026
18;Granada;137;Montillana;1189;618;571
18;Granada;138;Moraleda de Zafayona;3153;1596;1557
18;Granada;909;Morelábor;607;329;278
18;Granada;140;Motril;58020;28522;29498
18;Granada;141;Murtas;467;265;202
18;Granada;903;Nevada;1050;543;507
18;Granada;143;Nigüelas;1173;594;579
18;Granada;144;Nívar;994;519;475
18;Granada;145;Ogíjares;14160;7008;7152
18;Granada;146;Orce;1190;605;585
18;Granada;147;Órgiva;5725;2872;2853
18;Granada;148;Otívar;1034;524;510
18;Granada;150;Padul;8420;4223;4197
18;Granada;151;Pampaneira;321;156;165
18;Granada;152;Pedro Martínez;1107;539;568
18;Granada;153;Peligros;11394;5642;5752
18;Granada;154;Peza, La;1178;600;578
18;Granada;910;Pinar, El;877;460;417
18;Granada;157;Pinos Genil;1457;758;699
18;Granada;158;Pinos Puente;9930;4994;4936
18;Granada;159;Píñar;1138;623;515
18;Granada;161;Polícar;276;147;129
18;Granada;162;Polopos;1756;976;780
18;Granada;163;Pórtugos;382;197;185
18;Granada;164;Puebla de Don Fadrique;2250;1142;1108
18;Granada;165;Pulianas;5429;2696;2733
18;Granada;167;Purullena;2293;1166;1127
18;Granada;168;Quéntar;933;480;453
18;Granada;170;Rubite;394;213;181
18;Granada;171;Salar;2631;1319;1312
18;Granada;173;Salobreña;12381;6161;6220
18;Granada;174;Santa Cruz del Comercio;528;273;255
18;Granada;175;Santa Fe;15157;7427;7730
18;Granada;176;Soportújar;268;147;121
18;Granada;177;Sorvilán;538;297;241
18;Granada;901;Taha, La;653;337;316
18;Granada;178;Torre-Cardela;736;393;343
18;Granada;916;Torrenueva Costa;2682;1397;1285
18;Granada;179;Torvizcón;648;349;299
18;Granada;180;Trevélez;732;383;349
18;Granada;181;Turón;239;142;97
18;Granada;182;Ugíjar;2523;1253;1270
18;Granada;914;Valderrubio;2086;1024;1062
18;Granada;907;Valle del Zalabí;2128;1083;1045
18;Granada;902;Valle, El;914;455;459
18;Granada;183;Válor;675;347;328
18;Granada;911;Vegas del Genil;11166;5704;5462
18;Granada;184;Vélez de Benaudalla;2841;1414;1427
18;Granada;185;Ventas de Huelma;640;350;290
18;Granada;149;Villa de Otura;6952;3507;3445
18;Granada;908;Villamena;948;479;469
18;Granada;187;Villanueva de las Torres;582;311;271
18;Granada;188;Villanueva Mesía;2021;994;1027
18;Granada;189;Víznar;976;508;468
18;Granada;192;Zafarraya;2137;1129;1008
18;Granada;913;Zagra;834;420;414
18;Granada;193;Zubia, La;19155;9460;9695
18;Granada;194;Zújar;2548;1287;1261
19;Guadalajara;001;Abánades;48;26;22
19;Guadalajara;002;Ablanque;59;31;28
19;Guadalajara;003;Adobes;29;16;13
19;Guadalajara;004;Alaminos;60;28;32
19;Guadalajara;005;Alarilla;163;104;59
19;Guadalajara;006;Albalate de Zorita;943;520;423
19;Guadalajara;007;Albares;513;264;249
19;Guadalajara;008;Albendiego;49;30;19
19;Guadalajara;009;Alcocer;313;157;156
19;Guadalajara;010;Alcolea de las Peñas;13;8;5
19;Guadalajara;011;Alcolea del Pinar;320;172;148
19;Guadalajara;013;Alcoroches;126;79;47
19;Guadalajara;015;Aldeanueva de Guadalajara;86;51;35
19;Guadalajara;016;Algar de Mesa;55;39;16
19;Guadalajara;017;Algora;70;45;25
19;Guadalajara;018;Alhóndiga;157;91;66
19;Guadalajara;019;Alique;14;7;7
19;Guadalajara;020;Almadrones;57;38;19
19;Guadalajara;021;Almoguera;1289;667;622
19;Guadalajara;022;Almonacid de Zorita;685;344;341
19;Guadalajara;023;Alocén;172;84;88
19;Guadalajara;024;Alovera;12735;6498;6237
19;Guadalajara;027;Alustante;153;90;63
19;Guadalajara;031;Angón;10;8;2
19;Guadalajara;032;Anguita;156;79;77
19;Guadalajara;033;Anquela del Ducado;50;31;19
19;Guadalajara;034;Anquela del Pedregal;24;16;8
19;Guadalajara;036;Aranzueque;380;204;176
19;Guadalajara;037;Arbancón;150;89;61
19;Guadalajara;038;Arbeteta;22;17;5
19;Guadalajara;039;Argecilla;64;44;20
19;Guadalajara;040;Armallones;59;32;27
19;Guadalajara;041;Armuña de Tajuña;246;134;112
19;Guadalajara;042;Arroyo de las Fraguas;22;12;10
19;Guadalajara;043;Atanzón;100;66;34
19;Guadalajara;044;Atienza;405;228;177
19;Guadalajara;045;Auñón;142;80;62
19;Guadalajara;046;Azuqueca de Henares;35009;17744;17265
19;Guadalajara;047;Baides;56;29;27
19;Guadalajara;048;Baños de Tajo;19;14;5
19;Guadalajara;049;Bañuelos;14;12;2
19;Guadalajara;050;Barriopedro;15;11;4
19;Guadalajara;051;Berninches;49;32;17
19;Guadalajara;052;Bodera, La;22;14;8
19;Guadalajara;053;Brihuega;2410;1247;1163
19;Guadalajara;054;Budia;196;116;80
19;Guadalajara;055;Bujalaro;47;22;25
19;Guadalajara;057;Bustares;79;49;30
19;Guadalajara;058;Cabanillas del Campo;10442;5274;5168
19;Guadalajara;059;Campillo de Dueñas;78;45;33
19;Guadalajara;060;Campillo de Ranas;171;105;66
19;Guadalajara;061;Campisábalos;57;44;13
19;Guadalajara;064;Canredondo;67;44;23
19;Guadalajara;065;Cantalojas;151;90;61
19;Guadalajara;066;Cañizar;54;31;23
19;Guadalajara;067;Cardoso de la Sierra, El;60;37;23
19;Guadalajara;070;Casa de Uceda;89;48;41
19;Guadalajara;071;Casar, El;12062;6120;5942
19;Guadalajara;073;Casas de San Galindo;16;13;3
19;Guadalajara;074;Caspueñas;81;49;32
19;Guadalajara;075;Castejón de Henares;65;40;25
19;Guadalajara;076;Castellar de la Muela;22;13;9
19;Guadalajara;078;Castilforte;55;36;19
19;Guadalajara;079;Castilnuevo;8;5;3
19;Guadalajara;080;Cendejas de Enmedio;72;39;33
19;Guadalajara;081;Cendejas de la Torre;24;16;8
19;Guadalajara;082;Centenera;117;64;53
19;Guadalajara;103;Checa;282;172;110
19;Guadalajara;104;Chequilla;18;9;9
19;Guadalajara;106;Chillarón del Rey;88;49;39
19;Guadalajara;105;Chiloeches;3579;1862;1717
19;Guadalajara;086;Cifuentes;1645;851;794
19;Guadalajara;087;Cincovillas;22;10;12
19;Guadalajara;088;Ciruelas;122;68;54
19;Guadalajara;089;Ciruelos del Pinar;29;18;11
19;Guadalajara;090;Cobeta;114;58;56
19;Guadalajara;091;Cogollor;25;16;9
19;Guadalajara;092;Cogolludo;540;314;226
19;Guadalajara;095;Condemios de Abajo;14;9;5
19;Guadalajara;096;Condemios de Arriba;123;69;54
19;Guadalajara;097;Congostrina;17;13;4
19;Guadalajara;098;Copernal;28;18;10
19;Guadalajara;099;Corduente;349;191;158
19;Guadalajara;102;Cubillo de Uceda, El;121;65;56
19;Guadalajara;107;Driebes;366;198;168
19;Guadalajara;108;Durón;106;56;50
19;Guadalajara;109;Embid;33;18;15
19;Guadalajara;110;Escamilla;63;35;28
19;Guadalajara;111;Escariche;185;113;72
19;Guadalajara;112;Escopete;57;24;33
19;Guadalajara;113;Espinosa de Henares;628;325;303
19;Guadalajara;114;Esplegares;38;23;15
19;Guadalajara;115;Establés;37;24;13
19;Guadalajara;116;Estriégana;14;9;5
19;Guadalajara;117;Fontanar;2370;1237;1133
19;Guadalajara;118;Fuembellida;10;7;3
19;Guadalajara;119;Fuencemillán;86;56;30
19;Guadalajara;120;Fuentelahiguera de Albatages;136;77;59
19;Guadalajara;121;Fuentelencina;325;176;149
19;Guadalajara;122;Fuentelsaz;94;51;43
19;Guadalajara;123;Fuentelviejo;46;25;21
19;Guadalajara;124;Fuentenovilla;517;286;231
19;Guadalajara;125;Gajanejos;47;32;15
19;Guadalajara;126;Galápagos;2403;1264;1139
19;Guadalajara;127;Galve de Sorbe;100;55;45
19;Guadalajara;129;Gascueña de Bornova;28;16;12
19;Guadalajara;130;Guadalajara;85871;41272;44599
19;Guadalajara;132;Henche;104;57;47
19;Guadalajara;133;Heras de Ayuso;270;164;106
19;Guadalajara;134;Herrería;30;15;15
19;Guadalajara;135;Hiendelaencina;115;68;47
19;Guadalajara;136;Hijes;19;10;9
19;Guadalajara;138;Hita;294;162;132
19;Guadalajara;139;Hombrados;33;22;11
19;Guadalajara;142;Hontoba;318;180;138
19;Guadalajara;143;Horche;2535;1285;1250
19;Guadalajara;145;Hortezuela de Océn;42;26;16
19;Guadalajara;146;Huerce, La;51;32;19
19;Guadalajara;147;Huérmeces del Cerro;42;30;12
19;Guadalajara;148;Huertahernando;53;34;19
19;Guadalajara;150;Hueva;143;89;54
19;Guadalajara;151;Humanes;1496;751;745
19;Guadalajara;152;Illana;686;377;309
19;Guadalajara;153;Iniéstola;22;14;8
19;Guadalajara;154;Inviernas, Las;59;40;19
19;Guadalajara;155;Irueste;68;46;22
19;Guadalajara;156;Jadraque;1413;743;670
19;Guadalajara;157;Jirueque;59;41;18
19;Guadalajara;159;Ledanca;98;50;48
19;Guadalajara;160;Loranca de Tajuña;1249;681;568
19;Guadalajara;161;Lupiana;257;135;122
19;Guadalajara;162;Luzaga;69;38;31
19;Guadalajara;163;Luzón;68;33;35
19;Guadalajara;165;Majaelrayo;51;29;22
19;Guadalajara;166;Málaga del Fresno;180;97;83
19;Guadalajara;167;Malaguilla;152;82;70
19;Guadalajara;168;Mandayona;294;143;151
19;Guadalajara;169;Mantiel;34;22;12
19;Guadalajara;170;Maranchón;229;121;108
19;Guadalajara;171;Marchamalo;7474;3723;3751
19;Guadalajara;172;Masegoso de Tajuña;52;29;23
19;Guadalajara;173;Matarrubia;70;43;27
19;Guadalajara;174;Matillas;105;58;47
19;Guadalajara;175;Mazarete;38;18;20
19;Guadalajara;176;Mazuecos;268;148;120
19;Guadalajara;177;Medranda;66;36;30
19;Guadalajara;178;Megina;32;18;14
19;Guadalajara;179;Membrillera;98;54;44
19;Guadalajara;181;Miedes de Atienza;59;37;22
19;Guadalajara;182;Mierla, La;41;28;13
19;Guadalajara;184;Millana;110;67;43
19;Guadalajara;183;Milmarcos;73;47;26
19;Guadalajara;185;Miñosa, La;28;19;9
19;Guadalajara;186;Mirabueno;80;49;31
19;Guadalajara;187;Miralrío;51;29;22
19;Guadalajara;188;Mochales;46;25;21
19;Guadalajara;189;Mohernando;173;85;88
19;Guadalajara;190;Molina de Aragón;3275;1636;1639
19;Guadalajara;191;Monasterio;14;6;8
19;Guadalajara;192;Mondéjar;2645;1362;1283
19;Guadalajara;193;Montarrón;23;14;9
19;Guadalajara;194;Moratilla de los Meleros;103;57;46
19;Guadalajara;195;Morenilla;38;23;15
19;Guadalajara;196;Muduex;100;54;46
19;Guadalajara;197;Navas de Jadraque, Las;27;18;9
19;Guadalajara;198;Negredo;17;9;8
19;Guadalajara;199;Ocentejo;21;15;6
19;Guadalajara;200;Olivar, El;71;41;30
19;Guadalajara;201;Olmeda de Cobeta;66;36;30
19;Guadalajara;202;Olmeda de Jadraque, La;17;10;7
19;Guadalajara;203;Ordial, El;29;17;12
19;Guadalajara;204;Orea;180;107;73
19;Guadalajara;208;Pálmaces de Jadraque;41;26;15
19;Guadalajara;209;Pardos;43;24;19
19;Guadalajara;210;Paredes de Sigüenza;19;9;10
19;Guadalajara;211;Pareja;393;235;158
19;Guadalajara;212;Pastrana;850;435;415
19;Guadalajara;213;Pedregal, El;74;47;27
19;Guadalajara;214;Peñalén;73;43;30
19;Guadalajara;215;Peñalver;144;94;50
19;Guadalajara;216;Peralejos de las Truchas;143;76;67
19;Guadalajara;217;Peralveche;45;29;16
19;Guadalajara;218;Pinilla de Jadraque;50;27;23
19;Guadalajara;219;Pinilla de Molina;10;8;2
19;Guadalajara;220;Pioz;4052;2117;1935
19;Guadalajara;221;Piqueras;55;37;18
19;Guadalajara;222;Pobo de Dueñas, El;109;56;53
19;Guadalajara;223;Poveda de la Sierra;114;59;55
19;Guadalajara;224;Pozo de Almoguera;105;65;40
19;Guadalajara;225;Pozo de Guadalajara;1303;691;612
19;Guadalajara;226;Prádena de Atienza;49;35;14
19;Guadalajara;227;Prados Redondos;73;48;25
19;Guadalajara;228;Puebla de Beleña;40;24;16
19;Guadalajara;229;Puebla de Valles;58;32;26
19;Guadalajara;230;Quer;814;423;391
19;Guadalajara;231;Rebollosa de Jadraque;11;7;4
19;Guadalajara;232;Recuenco, El;58;37;21
19;Guadalajara;233;Renera;90;55;35
19;Guadalajara;234;Retiendas;48;33;15
19;Guadalajara;235;Riba de Saelices;105;63;42
19;Guadalajara;237;Rillo de Gallo;43;25;18
19;Guadalajara;238;Riofrío del Llano;55;31;24
19;Guadalajara;239;Robledillo de Mohernando;115;60;55
19;Guadalajara;240;Robledo de Corpes;52;30;22
19;Guadalajara;241;Romanillos de Atienza;36;24;12
19;Guadalajara;242;Romanones;99;50;49
19;Guadalajara;243;Rueda de la Sierra;38;28;10
19;Guadalajara;244;Sacecorbo;91;50;41
19;Guadalajara;245;Sacedón;1533;790;743
19;Guadalajara;246;Saelices de la Sal;43;23;20
19;Guadalajara;247;Salmerón;157;89;68
19;Guadalajara;248;San Andrés del Congosto;76;48;28
19;Guadalajara;249;San Andrés del Rey;29;16;13
19;Guadalajara;250;Santiuste;14;8;6
19;Guadalajara;251;Saúca;52;31;21
19;Guadalajara;252;Sayatón;78;46;32
19;Guadalajara;254;Selas;46;23;23
19;Guadalajara;901;Semillas;36;21;15
19;Guadalajara;255;Setiles;80;47;33
19;Guadalajara;256;Sienes;50;29;21
19;Guadalajara;257;Sigüenza;4309;2157;2152
19;Guadalajara;258;Solanillos del Extremo;91;53;38
19;Guadalajara;259;Somolinos;30;15;15
19;Guadalajara;260;Sotillo, El;42;22;20
19;Guadalajara;261;Sotodosos;33;17;16
19;Guadalajara;262;Tamajón;126;71;55
19;Guadalajara;263;Taragudo;49;28;21
19;Guadalajara;264;Taravilla;38;26;12
19;Guadalajara;265;Tartanedo;140;81;59
19;Guadalajara;266;Tendilla;307;170;137
19;Guadalajara;267;Terzaga;23;13;10
19;Guadalajara;268;Tierzo;49;30;19
19;Guadalajara;269;Toba, La;96;57;39
19;Guadalajara;271;Tordellego;48;27;21
19;Guadalajara;270;Tordelrábano;26;19;7
19;Guadalajara;272;Tordesilos;92;50;42
19;Guadalajara;274;Torija;1448;756;692
19;Guadalajara;279;Torre del Burgo;592;314;278
19;Guadalajara;277;Torrecuadrada de Molina;18;13;5
19;Guadalajara;278;Torrecuadradilla;24;14;10
19;Guadalajara;280;Torrejón del Rey;5434;2833;2601
19;Guadalajara;281;Torremocha de Jadraque;21;11;10
19;Guadalajara;282;Torremocha del Campo;166;94;72
19;Guadalajara;283;Torremocha del Pinar;40;19;21
19;Guadalajara;284;Torremochuela;10;7;3
19;Guadalajara;285;Torrubia;19;11;8
19;Guadalajara;286;Tórtola de Henares;1044;571;473
19;Guadalajara;287;Tortuera;194;103;91
19;Guadalajara;288;Tortuero;18;13;5
19;Guadalajara;289;Traíd;23;15;8
19;Guadalajara;290;Trijueque;1201;636;565
19;Guadalajara;291;Trillo;1319;690;629
19;Guadalajara;293;Uceda;2616;1358;1258
19;Guadalajara;294;Ujados;28;16;12
19;Guadalajara;296;Utande;31;23;8
19;Guadalajara;297;Valdarachas;40;20;20
19;Guadalajara;298;Valdearenas;76;52;24
19;Guadalajara;299;Valdeavellano;114;62;52
19;Guadalajara;300;Valdeaveruelo;1072;558;514
19;Guadalajara;301;Valdeconcha;40;22;18
19;Guadalajara;302;Valdegrudas;56;35;21
19;Guadalajara;303;Valdelcubo;45;31;14
19;Guadalajara;304;Valdenuño Fernández;257;140;117
19;Guadalajara;305;Valdepeñas de la Sierra;152;90;62
19;Guadalajara;306;Valderrebollo;23;12;11
19;Guadalajara;307;Valdesotos;26;17;9
19;Guadalajara;308;Valfermoso de Tajuña;60;41;19
19;Guadalajara;309;Valhermoso;23;12;11
19;Guadalajara;310;Valtablado del Río;7;4;3
19;Guadalajara;311;Valverde de los Arroyos;94;48;46
19;Guadalajara;314;Viana de Jadraque;46;32;14
19;Guadalajara;317;Villanueva de Alcorón;149;82;67
19;Guadalajara;318;Villanueva de Argecilla;31;19;12
19;Guadalajara;319;Villanueva de la Torre;6573;3308;3265
19;Guadalajara;321;Villares de Jadraque;45;28;17
19;Guadalajara;322;Villaseca de Henares;27;13;14
19;Guadalajara;323;Villaseca de Uceda;39;21;18
19;Guadalajara;324;Villel de Mesa;182;102;80
19;Guadalajara;325;Viñuelas;148;75;73
19;Guadalajara;326;Yebes;3791;1957;1834
19;Guadalajara;327;Yebra;444;240;204
19;Guadalajara;329;Yélamos de Abajo;71;39;32
19;Guadalajara;330;Yélamos de Arriba;78;47;31
19;Guadalajara;331;Yunquera de Henares;4044;2052;1992
19;Guadalajara;332;Yunta, La;89;53;36
19;Guadalajara;333;Zaorejas;116;77;39
19;Guadalajara;334;Zarzuela de Jadraque;44;27;17
19;Guadalajara;335;Zorita de los Canes;78;43;35
21;Huelva;001;Alájar;756;386;370
21;Huelva;002;Aljaraque;21260;10594;10666
21;Huelva;003;Almendro, El;826;438;388
21;Huelva;004;Almonaster la Real;1819;978;841
21;Huelva;005;Almonte;24191;11686;12505
21;Huelva;006;Alosno;3923;1929;1994
21;Huelva;007;Aracena;8107;3984;4123
21;Huelva;008;Aroche;3073;1528;1545
21;Huelva;009;Arroyomolinos de León;953;493;460
21;Huelva;010;Ayamonte;20946;10492;10454
21;Huelva;011;Beas;4257;2136;2121
21;Huelva;012;Berrocal;312;157;155
21;Huelva;013;Bollullos Par del Condado;14272;7092;7180
21;Huelva;014;Bonares;6058;3012;3046
21;Huelva;015;Cabezas Rubias;730;383;347
21;Huelva;016;Cala;1167;587;580
21;Huelva;017;Calañas;2791;1422;1369
21;Huelva;018;Campillo, El;2023;980;1043
21;Huelva;019;Campofrío;675;343;332
21;Huelva;020;Cañaveral de León;403;205;198
21;Huelva;021;Cartaya;19974;10228;9746
21;Huelva;022;Castaño del Robledo;223;121;102
21;Huelva;023;Cerro de Andévalo, El;2364;1167;1197
21;Huelva;030;Chucena;2222;1131;1091
21;Huelva;024;Corteconcepción;548;287;261
21;Huelva;025;Cortegana;4666;2368;2298
21;Huelva;026;Cortelazor;299;140;159
21;Huelva;027;Cumbres de Enmedio;56;34;22
21;Huelva;028;Cumbres de San Bartolomé;381;186;195
21;Huelva;029;Cumbres Mayores;1755;871;884
21;Huelva;031;Encinasola;1305;655;650
21;Huelva;032;Escacena del Campo;2284;1112;1172
21;Huelva;033;Fuenteheridos;678;338;340
21;Huelva;034;Galaroza;1379;681;698
21;Huelva;035;Gibraleón;12607;6274;6333
21;Huelva;036;Granada de Río-Tinto, La;239;124;115
21;Huelva;037;Granado, El;516;274;242
21;Huelva;038;Higuera de la Sierra;1287;666;621
21;Huelva;039;Hinojales;325;163;162
21;Huelva;040;Hinojos;3976;1994;1982
21;Huelva;041;Huelva;143663;69003;74660
21;Huelva;042;Isla Cristina;21264;10639;10625
21;Huelva;043;Jabugo;2250;1132;1118
21;Huelva;044;Lepe;27431;14027;13404
21;Huelva;045;Linares de la Sierra;263;127;136
21;Huelva;046;Lucena del Puerto;3371;1757;1614
21;Huelva;047;Manzanilla;2135;1092;1043
21;Huelva;048;Marines, Los;396;212;184
21;Huelva;049;Minas de Riotinto;3848;1866;1982
21;Huelva;050;Moguer;22088;11022;11066
21;Huelva;051;Nava, La;266;137;129
21;Huelva;052;Nerva;5235;2517;2718
21;Huelva;053;Niebla;4117;2074;2043
21;Huelva;054;Palma del Condado, La;10761;5361;5400
21;Huelva;055;Palos de la Frontera;11289;5737;5552
21;Huelva;056;Paterna del Campo;3509;1784;1725
21;Huelva;057;Paymogo;1159;583;576
21;Huelva;058;Puebla de Guzmán;3073;1581;1492
21;Huelva;059;Puerto Moral;282;136;146
21;Huelva;060;Punta Umbría;15242;7764;7478
21;Huelva;061;Rociana del Condado;7855;3944;3911
21;Huelva;062;Rosal de la Frontera;1697;842;855
21;Huelva;063;San Bartolomé de la Torre;3736;1864;1872
21;Huelva;064;San Juan del Puerto;9300;4674;4626
21;Huelva;066;San Silvestre de Guzmán;623;326;297
21;Huelva;065;Sanlúcar de Guadiana;409;203;206
21;Huelva;067;Santa Ana la Real;476;222;254
21;Huelva;068;Santa Bárbara de Casa;1035;511;524
21;Huelva;069;Santa Olalla del Cala;2001;1035;966
21;Huelva;070;Trigueros;7713;3849;3864
21;Huelva;071;Valdelarco;239;112;127
21;Huelva;072;Valverde del Camino;12820;6311;6509
21;Huelva;073;Villablanca;2848;1389;1459
21;Huelva;074;Villalba del Alcor;3338;1644;1694
21;Huelva;075;Villanueva de las Cruces;373;176;197
21;Huelva;076;Villanueva de los Castillejos;2820;1411;1409
21;Huelva;077;Villarrasa;2176;1103;1073
21;Huelva;078;Zalamea la Real;3068;1545;1523
21;Huelva;902;Zarza-Perrunal, La;1267;640;627
21;Huelva;079;Zufre;808;422;386
22;Huesca;001;Abiego;248;130;118
22;Huesca;002;Abizanda;150;76;74
22;Huesca;003;Adahuesca;177;96;81
22;Huesca;004;Agüero;129;76;53
22;Huesca;907;Aínsa-Sobrarbe;2201;1120;1081
22;Huesca;006;Aisa;320;176;144
22;Huesca;007;Albalate de Cinca;1103;592;511
22;Huesca;008;Albalatillo;176;93;83
22;Huesca;009;Albelda;698;364;334
22;Huesca;011;Albero Alto;117;67;50
22;Huesca;012;Albero Bajo;135;72;63
22;Huesca;013;Alberuela de Tubo;301;151;150
22;Huesca;014;Alcalá de Gurrea;248;131;117
22;Huesca;015;Alcalá del Obispo;318;173;145
22;Huesca;016;Alcampell;631;310;321
22;Huesca;017;Alcolea de Cinca;1155;622;533
22;Huesca;018;Alcubierre;360;196;164
22;Huesca;019;Alerre;199;101;98
22;Huesca;020;Alfántega;130;66;64
22;Huesca;021;Almudévar;2379;1214;1165
22;Huesca;022;Almunia de San Juan;658;339;319
22;Huesca;023;Almuniente;460;238;222
22;Huesca;024;Alquézar;303;164;139
22;Huesca;025;Altorricón;1417;756;661
22;Huesca;027;Angüés;354;189;165
22;Huesca;028;Ansó;405;204;201
22;Huesca;029;Antillón;140;70;70
22;Huesca;032;Aragüés del Puerto;115;65;50
22;Huesca;035;Arén;313;172;141
22;Huesca;036;Argavieso;95;56;39
22;Huesca;037;Arguis;127;72;55
22;Huesca;039;Ayerbe;1009;500;509
22;Huesca;040;Azanuy-Alins;168;80;88
22;Huesca;041;Azara;171;86;85
22;Huesca;042;Azlor;143;65;78
22;Huesca;043;Baélls;104;59;45
22;Huesca;044;Bailo;267;160;107
22;Huesca;045;Baldellou;76;44;32
22;Huesca;046;Ballobar;812;423;389
22;Huesca;047;Banastás;295;153;142
22;Huesca;048;Barbastro;16979;8256;8723
22;Huesca;049;Barbués;78;47;31
22;Huesca;050;Barbuñales;96;48;48
22;Huesca;051;Bárcabo;103;57;46
22;Huesca;052;Belver de Cinca;1275;742;533
22;Huesca;053;Benabarre;1124;590;534
22;Huesca;054;Benasque;2155;1151;1004
22;Huesca;246;Beranuy;82;49;33
22;Huesca;055;Berbegal;347;178;169
22;Huesca;057;Bielsa;457;242;215
22;Huesca;058;Bierge;239;132;107
22;Huesca;059;Biescas;1463;768;695
22;Huesca;060;Binaced;1575;852;723
22;Huesca;061;Binéfar;9561;5003;4558
22;Huesca;062;Bisaurri;167;90;77
22;Huesca;063;Biscarrués;182;97;85
22;Huesca;064;Blecua y Torres;182;106;76
22;Huesca;066;Boltaña;1016;546;470
22;Huesca;067;Bonansa;88;50;38
22;Huesca;068;Borau;74;43;31
22;Huesca;069;Broto;522;292;230
22;Huesca;072;Caldearenas;229;136;93
22;Huesca;074;Campo;278;149;129
22;Huesca;075;Camporrélls;134;71;63
22;Huesca;076;Canal de Berdún;314;176;138
22;Huesca;077;Candasnos;462;255;207
22;Huesca;078;Canfranc;540;300;240
22;Huesca;079;Capdesaso;198;83;115
22;Huesca;080;Capella;349;182;167
22;Huesca;081;Casbas de Huesca;270;146;124
22;Huesca;083;Castejón de Monegros;522;283;239
22;Huesca;084;Castejón de Sos;747;381;366
22;Huesca;082;Castejón del Puente;318;167;151
22;Huesca;085;Castelflorite;106;54;52
22;Huesca;086;Castiello de Jaca;243;136;107
22;Huesca;087;Castigaleu;84;51;33
22;Huesca;088;Castillazuelo;162;80;82
22;Huesca;089;Castillonroy;313;164;149
22;Huesca;094;Chalamera;106;56;50
22;Huesca;095;Chía;83;54;29
22;Huesca;096;Chimillas;393;200;193
22;Huesca;090;Colungo;110;62;48
22;Huesca;099;Esplús;581;290;291
22;Huesca;102;Estada;208;122;86
22;Huesca;103;Estadilla;800;385;415
22;Huesca;105;Estopiñán del Castillo;120;65;55
22;Huesca;106;Fago;22;12;10
22;Huesca;107;Fanlo;101;63;38
22;Huesca;109;Fiscal;330;182;148
22;Huesca;110;Fonz;859;434;425
22;Huesca;111;Foradada del Toscar;172;91;81
22;Huesca;112;Fraga;15033;7643;7390
22;Huesca;113;Fueva, La;587;312;275
22;Huesca;114;Gistaín;142;75;67
22;Huesca;115;Grado, El;400;210;190
22;Huesca;116;Grañén;1762;913;849
22;Huesca;117;Graus;3395;1666;1729
22;Huesca;119;Gurrea de Gállego;1467;744;723
22;Huesca;122;Hoz de Jaca;70;35;35
22;Huesca;908;Hoz y Costean;223;129;94
22;Huesca;124;Huerto;206;112;94
22;Huesca;125;Huesca;53132;25352;27780
22;Huesca;126;Ibieca;96;55;41
22;Huesca;127;Igriés;723;382;341
22;Huesca;128;Ilche;211;104;107
22;Huesca;129;Isábena;235;119;116
22;Huesca;130;Jaca;12988;6357;6631
22;Huesca;131;Jasa;92;52;40
22;Huesca;133;Labuerda;162;87;75
22;Huesca;135;Laluenga;197;103;94
22;Huesca;136;Lalueza;892;465;427
22;Huesca;137;Lanaja;1174;621;553
22;Huesca;139;Laperdiguera;91;47;44
22;Huesca;141;Lascellas-Ponzano;129;82;47
22;Huesca;142;Lascuarre;132;68;64
22;Huesca;143;Laspaúles;230;135;95
22;Huesca;144;Laspuña;298;161;137
22;Huesca;149;Loarre;338;189;149
22;Huesca;150;Loporzano;530;300;230
22;Huesca;151;Loscorrales;99;50;49
22;Huesca;905;Lupiñén-Ortilla;342;171;171
22;Huesca;155;Monesma y Cajigar;76;43;33
22;Huesca;156;Monflorite-Lascasas;404;215;189
22;Huesca;157;Montanuy;212;123;89
22;Huesca;158;Monzón;17236;8683;8553
22;Huesca;160;Naval;275;143;132
22;Huesca;162;Novales;156;75;81
22;Huesca;163;Nueno;537;295;242
22;Huesca;164;Olvena;55;29;26
22;Huesca;165;Ontiñena;518;261;257
22;Huesca;167;Osso de Cinca;681;376;305
22;Huesca;168;Palo;27;14;13
22;Huesca;170;Panticosa;784;409;375
22;Huesca;172;Peñalba;611;314;297
22;Huesca;173;Peñas de Riglos, Las;248;158;90
22;Huesca;174;Peralta de Alcofea;556;291;265
22;Huesca;175;Peralta de Calasanz;210;122;88
22;Huesca;176;Peraltilla;196;98;98
22;Huesca;177;Perarrúa;111;59;52
22;Huesca;178;Pertusa;113;65;48
22;Huesca;181;Piracés;102;54;48
22;Huesca;182;Plan;283;143;140
22;Huesca;184;Poleñino;200;107;93
22;Huesca;186;Pozán de Vero;228;111;117
22;Huesca;187;Puebla de Castro, La;383;196;187
22;Huesca;188;Puente de Montañana;89;38;51
22;Huesca;902;Puente la Reina de Jaca;255;133;122
22;Huesca;189;Puértolas;212;117;95
22;Huesca;190;Pueyo de Araguás, El;161;89;72
22;Huesca;193;Pueyo de Santa Cruz;318;162;156
22;Huesca;195;Quicena;280;139;141
22;Huesca;197;Robres;527;268;259
22;Huesca;199;Sabiñánigo;9238;4610;4628
22;Huesca;200;Sahún;312;160;152
22;Huesca;201;Salas Altas;316;161;155
22;Huesca;202;Salas Bajas;175;86;89
22;Huesca;203;Salillas;94;53;41
22;Huesca;204;Sallent de Gállego;1478;732;746
22;Huesca;205;San Esteban de Litera;535;270;265
22;Huesca;207;San Juan de Plan;153;84;69
22;Huesca;903;San Miguel del Cinca;795;406;389
22;Huesca;206;Sangarrén;223;121;102
22;Huesca;208;Santa Cilia;240;123;117
22;Huesca;209;Santa Cruz de la Serós;183;109;74
22;Huesca;906;Santa María de Dulcis;209;113;96
22;Huesca;212;Santaliestra y San Quílez;82;41;41
22;Huesca;213;Sariñena;4160;2160;2000
22;Huesca;214;Secastilla;140;62;78
22;Huesca;215;Seira;148;83;65
22;Huesca;217;Sena;495;265;230
22;Huesca;218;Senés de Alcubierre;41;22;19
22;Huesca;220;Sesa;161;90;71
22;Huesca;221;Sesué;122;63;59
22;Huesca;222;Siétamo;679;369;310
22;Huesca;223;Sopeira;91;51;40
22;Huesca;904;Sotonera, La;872;469;403
22;Huesca;225;Tamarite de Litera;3476;1789;1687
22;Huesca;226;Tardienta;961;477;484
22;Huesca;227;Tella-Sin;232;136;96
22;Huesca;228;Tierz;771;390;381
22;Huesca;229;Tolva;121;66;55
22;Huesca;230;Torla-Ordesa;304;158;146
22;Huesca;232;Torralba de Aragón;101;59;42
22;Huesca;233;Torre la Ribera;101;53;48
22;Huesca;234;Torrente de Cinca;1154;591;563
22;Huesca;235;Torres de Alcanadre;86;53;33
22;Huesca;236;Torres de Barbués;252;125;127
22;Huesca;239;Tramaced;104;66;38
22;Huesca;242;Valfarta;67;41;26
22;Huesca;243;Valle de Bardají;30;18;12
22;Huesca;901;Valle de Hecho;822;428;394
22;Huesca;244;Valle de Lierp;39;20;19
22;Huesca;245;Velilla de Cinca;461;244;217
22;Huesca;909;Vencillón;389;207;182
22;Huesca;247;Viacamp y Litera;36;24;12
22;Huesca;248;Vicién;113;66;47
22;Huesca;249;Villanova;168;81;87
22;Huesca;250;Villanúa;432;224;208
22;Huesca;251;Villanueva de Sigena;390;201;189
22;Huesca;252;Yebra de Basa;143;86;57
22;Huesca;253;Yésero;57;34;23
22;Huesca;254;Zaidín;1763;929;834
23;Jaén;001;Albanchez de Mágina;1024;532;492
23;Jaén;002;Alcalá la Real;21605;10612;10993
23;Jaén;003;Alcaudete;10498;5166;5332
23;Jaén;004;Aldeaquemada;481;265;216
23;Jaén;005;Andújar;36793;17978;18815
23;Jaén;006;Arjona;5542;2730;2812
23;Jaén;007;Arjonilla;3575;1812;1763
23;Jaén;008;Arquillos;1734;866;868
23;Jaén;905;Arroyo del Ojanco;2288;1158;1130
23;Jaén;009;Baeza;15841;7841;8000
23;Jaén;010;Bailén;17667;8773;8894
23;Jaén;011;Baños de la Encina;2582;1332;1250
23;Jaén;012;Beas de Segura;5130;2683;2447
23;Jaén;902;Bedmar y Garcíez;2642;1341;1301
23;Jaén;014;Begíjar;3029;1526;1503
23;Jaén;015;Bélmez de la Moraleda;1567;795;772
23;Jaén;016;Benatae;448;229;219
23;Jaén;017;Cabra del Santo Cristo;1779;930;849
23;Jaén;018;Cambil;2703;1411;1292
23;Jaén;019;Campillo de Arenas;1760;896;864
23;Jaén;020;Canena;1831;935;896
23;Jaén;021;Carboneros;615;318;297
23;Jaén;901;Cárcheles;1363;716;647
23;Jaén;024;Carolina, La;15261;7546;7715
23;Jaén;025;Castellar;3314;1670;1644
23;Jaén;026;Castillo de Locubín;4058;2011;2047
23;Jaén;027;Cazalilla;824;404;420
23;Jaén;028;Cazorla;7441;3606;3835
23;Jaén;029;Chiclana de Segura;965;489;476
23;Jaén;030;Chilluévar;1434;692;742
23;Jaén;031;Escañuela;950;468;482
23;Jaén;032;Espeluy;619;304;315
23;Jaén;033;Frailes;1575;783;792
23;Jaén;034;Fuensanta de Martos;3074;1539;1535
23;Jaén;035;Fuerte del Rey;1357;688;669
23;Jaén;037;Génave;611;335;276
23;Jaén;038;Guardia de Jaén, La;5011;2526;2485
23;Jaén;039;Guarromán;2724;1363;1361
23;Jaén;041;Higuera de Calatrava;619;332;287
23;Jaén;042;Hinojares;401;215;186
23;Jaén;043;Hornos;601;301;300
23;Jaén;044;Huelma;5776;2871;2905
23;Jaén;045;Huesa;2489;1251;1238
23;Jaén;046;Ibros;2832;1422;1410
23;Jaén;047;Iruela, La;1899;948;951
23;Jaén;048;Iznatoraf;960;496;464
23;Jaén;049;Jabalquinto;2039;1025;1014
23;Jaén;050;Jaén;112999;54420;58579
23;Jaén;051;Jamilena;3293;1668;1625
23;Jaén;052;Jimena;1284;624;660
23;Jaén;053;Jódar;11667;5822;5845
23;Jaén;040;Lahiguera;1710;840;870
23;Jaén;054;Larva;472;243;229
23;Jaén;055;Linares;57414;28059;29355
23;Jaén;056;Lopera;3665;1855;1810
23;Jaén;057;Lupión;842;413;429
23;Jaén;058;Mancha Real;11264;5584;5680
23;Jaén;059;Marmolejo;6812;3394;3418
23;Jaén;060;Martos;24215;12012;12203
23;Jaén;061;Mengíbar;9941;4946;4995
23;Jaén;062;Montizón;1725;894;831
23;Jaén;063;Navas de San Juan;4517;2260;2257
23;Jaén;064;Noalejo;1970;996;974
23;Jaén;065;Orcera;1811;914;897
23;Jaén;066;Peal de Becerro;5266;2602;2664
23;Jaén;067;Pegalajar;2919;1470;1449
23;Jaén;069;Porcuna;6235;3144;3091
23;Jaén;070;Pozo Alcón;4673;2398;2275
23;Jaén;071;Puente de Génave;2159;1080;1079
23;Jaén;072;Puerta de Segura, La;2268;1136;1132
23;Jaén;073;Quesada;5209;2645;2564
23;Jaén;074;Rus;3547;1814;1733
23;Jaén;075;Sabiote;3918;1932;1986
23;Jaén;076;Santa Elena;888;464;424
23;Jaén;077;Santiago de Calatrava;699;371;328
23;Jaén;904;Santiago-Pontones;2956;1521;1435
23;Jaén;079;Santisteban del Puerto;4472;2304;2168
23;Jaén;080;Santo Tomé;2139;1087;1052
23;Jaén;081;Segura de la Sierra;1790;874;916
23;Jaén;082;Siles;2241;1115;1126
23;Jaén;084;Sorihuela del Guadalimar;1100;572;528
23;Jaén;085;Torreblascopedro;2546;1292;1254
23;Jaén;086;Torredelcampo;14247;7143;7104
23;Jaén;087;Torredonjimeno;13696;6734;6962
23;Jaén;088;Torreperogil;7276;3552;3724
23;Jaén;090;Torres;1406;721;685
23;Jaén;091;Torres de Albánchez;787;401;386
23;Jaén;092;Úbeda;34345;16813;17532
23;Jaén;093;Valdepeñas de Jaén;3714;1841;1873
23;Jaén;094;Vilches;4436;2216;2220
23;Jaén;095;Villacarrillo;10726;5391;5335
23;Jaén;096;Villanueva de la Reina;3081;1544;1537
23;Jaén;097;Villanueva del Arzobispo;8193;4214;3979
23;Jaén;098;Villardompardo;965;488;477
23;Jaén;099;Villares, Los;6014;3004;3010
23;Jaén;101;Villarrodrigo;405;215;190
23;Jaén;903;Villatorres;4316;2184;2132
24;León;001;Acebedo;187;107;80
24;León;002;Algadefe;289;151;138
24;León;003;Alija del Infantado;647;323;324
24;León;004;Almanza;574;327;247
24;León;005;Antigua, La;360;208;152
24;León;006;Ardón;560;303;257
24;León;007;Arganza;816;407;409
24;León;008;Astorga;10867;5113;5754
24;León;009;Balboa;290;158;132
24;León;010;Bañeza, La;10338;4977;5361
24;León;011;Barjas;190;101;89
24;León;012;Barrios de Luna, Los;314;179;135
24;León;014;Bembibre;8705;4220;4485
24;León;015;Benavides;2455;1215;1240
24;León;016;Benuza;530;309;221
24;León;017;Bercianos del Páramo;562;288;274
24;León;018;Bercianos del Real Camino;193;99;94
24;León;019;Berlanga del Bierzo;360;164;196
24;León;020;Boca de Huérgano;464;280;184
24;León;021;Boñar;1832;927;905
24;León;022;Borrenes;315;168;147
24;León;023;Brazuelo;295;161;134
24;León;024;Burgo Ranero, El;715;377;338
24;León;025;Burón;308;176;132
24;León;026;Bustillo del Páramo;1165;599;566
24;León;027;Cabañas Raras;1356;698;658
24;León;028;Cabreros del Río;413;223;190
24;León;029;Cabrillanes;759;395;364
24;León;030;Cacabelos;5118;2543;2575
24;León;031;Calzada del Coto;223;133;90
24;León;032;Campazas;119;55;64
24;León;033;Campo de Villavidel;209;114;95
24;León;034;Camponaraya;4096;2022;2074
24;León;036;Candín;274;151;123
24;León;037;Cármenes;352;196;156
24;León;038;Carracedelo;3425;1713;1712
24;León;039;Carrizo;2228;1130;1098
24;León;040;Carrocera;451;249;202
24;León;041;Carucedo;562;284;278
24;León;042;Castilfalé;69;40;29
24;León;043;Castrillo de Cabrera;119;69;50
24;León;044;Castrillo de la Valduerna;158;70;88
24;León;046;Castrocalbón;964;499;465
24;León;047;Castrocontrigo;765;412;353
24;León;049;Castropodame;1628;842;786
24;León;050;Castrotierra de Valmadrigal;115;60;55
24;León;051;Cea;413;219;194
24;León;052;Cebanico;147;92;55
24;León;053;Cebrones del Río;451;248;203
24;León;065;Chozas de Abajo;2581;1347;1234
24;León;054;Cimanes de la Vega;463;244;219
24;León;055;Cimanes del Tejar;724;390;334
24;León;056;Cistierna;3135;1548;1587
24;León;057;Congosto;1475;743;732
24;León;058;Corbillos de los Oteros;199;112;87
24;León;059;Corullón;887;447;440
24;León;060;Crémenes;544;292;252
24;León;061;Cuadros;2001;1007;994
24;León;062;Cubillas de los Oteros;141;81;60
24;León;063;Cubillas de Rueda;388;206;182
24;León;064;Cubillos del Sil;1816;952;864
24;León;066;Destriana;479;224;255
24;León;067;Encinedo;709;375;334
24;León;068;Ercina, La;457;240;217
24;León;069;Escobar de Campos;39;22;17
24;León;070;Fabero;4493;2194;2299
24;León;071;Folgoso de la Ribera;1080;524;556
24;León;073;Fresno de la Vega;496;256;240
24;León;074;Fuentes de Carbajal;98;53;45
24;León;076;Garrafe de Torío;1504;811;693
24;León;077;Gordaliza del Pino;252;124;128
24;León;078;Gordoncillo;409;209;200
24;León;079;Gradefes;954;521;433
24;León;080;Grajal de Campos;227;113;114
24;León;081;Gusendos de los Oteros;124;64;60
24;León;082;Hospital de Órbigo;998;498;500
24;León;083;Igüeña;1145;598;547
24;León;084;Izagre;159;80;79
24;León;086;Joarilla de las Matas;296;159;137
24;León;087;Laguna Dalga;645;346;299
24;León;088;Laguna de Negrillos;1058;545;513
24;León;089;León;124303;56307;67996
24;León;092;Llamas de la Ribera;825;437;388
24;León;090;Lucillo;376;199;177
24;León;091;Luyego;628;336;292
24;León;093;Magaz de Cepeda;359;187;172
24;León;094;Mansilla de las Mulas;1733;868;865
24;León;095;Mansilla Mayor;334;181;153
24;León;096;Maraña;115;67;48
24;León;097;Matadeón de los Oteros;228;118;110
24;León;098;Matallana de Torío;1270;667;603
24;León;099;Matanza;165;89;76
24;León;100;Molinaseca;884;488;396
24;León;101;Murias de Paredes;399;201;198
24;León;102;Noceda del Bierzo;672;345;327
24;León;103;Oencia;274;161;113
24;León;104;Omañas, Las;266;144;122
24;León;105;Onzonilla;1835;940;895
24;León;106;Oseja de Sajambre;232;135;97
24;León;107;Pajares de los Oteros;266;162;104
24;León;108;Palacios de la Valduerna;379;183;196
24;León;109;Palacios del Sil;941;501;440
24;León;110;Páramo del Sil;1259;646;613
24;León;112;Peranzanes;300;177;123
24;León;113;Pobladura de Pelayo García;373;193;180
24;León;114;Pola de Gordón, La;3224;1628;1596
24;León;115;Ponferrada;64674;30671;34003
24;León;116;Posada de Valdeón;415;241;174
24;León;117;Pozuelo del Páramo;431;212;219
24;León;118;Prado de la Guzpeña;107;60;47
24;León;119;Priaranza del Bierzo;788;401;387
24;León;120;Prioro;340;198;142
24;León;121;Puebla de Lillo;681;394;287
24;León;122;Puente de Domingo Flórez;1500;790;710
24;León;123;Quintana del Castillo;735;412;323
24;León;124;Quintana del Marco;362;196;166
24;León;125;Quintana y Congosto;351;180;171
24;León;127;Regueras de Arriba;280;151;129
24;León;129;Reyero;116;64;52
24;León;130;Riaño;463;264;199
24;León;131;Riego de la Vega;742;399;343
24;León;132;Riello;647;364;283
24;León;133;Rioseco de Tapia;374;211;163
24;León;134;Robla, La;3783;1878;1905
24;León;136;Roperuelos del Páramo;524;265;259
24;León;137;Sabero;1140;586;554
24;León;139;Sahagún;2493;1226;1267
24;León;141;San Adrián del Valle;103;57;46
24;León;142;San Andrés del Rabanedo;30615;14574;16041
24;León;144;San Cristóbal de la Polantera;689;358;331
24;León;145;San Emiliano;646;361;285
24;León;146;San Esteban de Nogales;256;132;124
24;León;148;San Justo de la Vega;1843;942;901
24;León;149;San Millán de los Caballeros;167;87;80
24;León;150;San Pedro Bercianos;238;132;106
24;León;143;Sancedo;556;277;279
24;León;151;Santa Colomba de Curueño;479;255;224
24;León;152;Santa Colomba de Somoza;511;275;236
24;León;153;Santa Cristina de Valmadrigal;267;142;125
24;León;154;Santa Elena de Jamuz;1066;562;504
24;León;155;Santa María de la Isla;475;247;228
24;León;158;Santa María de Ordás;318;166;152
24;León;156;Santa María del Monte de Cea;227;125;102
24;León;157;Santa María del Páramo;3089;1519;1570
24;León;159;Santa Marina del Rey;1916;956;960
24;León;160;Santas Martas;743;400;343
24;León;161;Santiago Millas;338;186;152
24;León;162;Santovenia de la Valdoncina;2126;1083;1043
24;León;163;Sariegos;5050;2528;2522
24;León;164;Sena de Luna;383;189;194
24;León;165;Sobrado;312;159;153
24;León;166;Soto de la Vega;1529;805;724
24;León;167;Soto y Amío;783;408;375
24;León;168;Toral de los Guzmanes;500;273;227
24;León;206;Toral de los Vados;1846;907;939
24;León;169;Toreno;3105;1539;1566
24;León;170;Torre del Bierzo;2164;1112;1052
24;León;171;Trabadelo;357;195;162
24;León;172;Truchas;443;231;212
24;León;173;Turcia;993;509;484
24;León;174;Urdiales del Páramo;510;272;238
24;León;185;Val de San Lorenzo;505;253;252
24;León;175;Valdefresno;2187;1131;1056
24;León;176;Valdefuentes del Páramo;321;171;150
24;León;177;Valdelugueros;508;290;218
24;León;178;Valdemora;82;36;46
24;León;179;Valdepiélago;344;197;147
24;León;180;Valdepolo;1219;654;565
24;León;181;Valderas;1623;822;801
24;León;182;Valderrey;446;224;222
24;León;183;Valderrueda;832;438;394
24;León;184;Valdesamario;194;109;85
24;León;187;Valdevimbre;978;505;473
24;León;188;Valencia de Don Juan;5351;2628;2723
24;León;191;Vallecillo;128;78;50
24;León;189;Valverde de la Virgen;7328;3777;3551
24;León;190;Valverde-Enrique;155;78;77
24;León;193;Vecilla, La;386;206;180
24;León;196;Vega de Espinareda;2069;1054;1015
24;León;197;Vega de Infanzones;854;436;418
24;León;198;Vega de Valcarce;606;317;289
24;León;194;Vegacervera;279;144;135
24;León;199;Vegaquemada;439;244;195
24;León;201;Vegas del Condado;1114;650;464
24;León;202;Villablino;8620;4241;4379
24;León;203;Villabraz;97;56;41
24;León;205;Villadangos del Páramo;1132;588;544
24;León;207;Villademor de la Vega;327;172;155
24;León;209;Villafranca del Bierzo;2899;1385;1514
24;León;210;Villagatón;613;324;289
24;León;211;Villamandos;294;159;135
24;León;901;Villamanín;949;483;466
24;León;212;Villamañán;1126;568;558
24;León;213;Villamartín de Don Sancho;176;96;80
24;León;214;Villamejil;687;368;319
24;León;215;Villamol;164;85;79
24;León;216;Villamontán de la Valduerna;715;378;337
24;León;217;Villamoratiel de las Matas;143;81;62
24;León;218;Villanueva de las Manzanas;488;258;230
24;León;219;Villaobispo de Otero;541;296;245
24;León;902;Villaornate y Castro;356;183;173
24;León;221;Villaquejida;870;446;424
24;León;222;Villaquilambre;18638;9230;9408
24;León;223;Villarejo de Órbigo;2974;1459;1515
24;León;224;Villares de Órbigo;611;325;286
24;León;225;Villasabariego;1121;588;533
24;León;226;Villaselán;199;116;83
24;León;227;Villaturiel;1852;975;877
24;León;228;Villazala;665;353;312
24;León;229;Villazanzo de Valderaduey;419;244;175
24;León;230;Zotes del Páramo;427;240;187
25;Lleida;001;Abella de la Conca;179;96;83
25;Lleida;002;Àger;588;320;268
25;Lleida;003;Agramunt;5371;2689;2682
25;Lleida;038;Aitona;2591;1358;1233
25;Lleida;004;Alamús, Els;819;412;407
25;Lleida;005;Alàs i Cerc;329;171;158
25;Lleida;006;Albagés, L';369;194;175
25;Lleida;007;Albatàrrec;2221;1150;1071
25;Lleida;008;Albesa;1556;855;701
25;Lleida;009;Albi, L';764;389;375
25;Lleida;010;Alcanó;235;119;116
25;Lleida;011;Alcarràs;9514;4957;4557
25;Lleida;012;Alcoletge;3420;1775;1645
25;Lleida;013;Alfarràs;2797;1459;1338
25;Lleida;014;Alfés;312;162;150
25;Lleida;015;Algerri;386;206;180
25;Lleida;016;Alguaire;2971;1562;1409
25;Lleida;017;Alins;276;144;132
25;Lleida;019;Almacelles;6791;3584;3207
25;Lleida;020;Almatret;307;172;135
25;Lleida;021;Almenar;3398;1791;1607
25;Lleida;022;Alòs de Balaguer;130;74;56
25;Lleida;023;Alpicat;6255;3134;3121
25;Lleida;024;Alt Àneu;405;231;174
25;Lleida;027;Anglesola;1363;682;681
25;Lleida;029;Arbeca;2144;1100;1044
25;Lleida;031;Arres;65;42;23
25;Lleida;032;Arsèguel;84;48;36
25;Lleida;033;Artesa de Lleida;1504;789;715
25;Lleida;034;Artesa de Segre;3432;1766;1666
25;Lleida;036;Aspa;224;113;111
25;Lleida;037;Avellanes i Santa Linya, Les;449;259;190
25;Lleida;039;Baix Pallars;335;182;153
25;Lleida;040;Balaguer;17162;8746;8416
25;Lleida;041;Barbens;878;467;411
25;Lleida;042;Baronia de Rialb, La;237;121;116
25;Lleida;044;Bassella;224;112;112
25;Lleida;045;Bausen;58;30;28
25;Lleida;046;Belianes;525;269;256
25;Lleida;170;Bellaguarda;287;152;135
25;Lleida;047;Bellcaire d'Urgell;1230;627;603
25;Lleida;048;Bell-lloc d'Urgell;2315;1139;1176
25;Lleida;049;Bellmunt d'Urgell;185;89;96
25;Lleida;050;Bellpuig;5133;2705;2428
25;Lleida;051;Bellver de Cerdanya;1937;1009;928
25;Lleida;052;Bellvís;2255;1149;1106
25;Lleida;053;Benavent de Segrià;1499;781;718
25;Lleida;055;Biosca;176;94;82
25;Lleida;057;Bòrdes, Es;259;144;115
25;Lleida;058;Borges Blanques, Les;6087;3105;2982
25;Lleida;059;Bossòst;1109;542;567
25;Lleida;056;Bovera;247;133;114
25;Lleida;060;Cabanabona;75;36;39
25;Lleida;061;Cabó;92;49;43
25;Lleida;062;Camarasa;817;410;407
25;Lleida;063;Canejan;107;57;50
25;Lleida;904;Castell de Mur;183;104;79
25;Lleida;064;Castellar de la Ribera;134;67;67
25;Lleida;067;Castelldans;960;511;449
25;Lleida;068;Castellnou de Seana;683;361;322
25;Lleida;069;Castelló de Farfanya;536;288;248
25;Lleida;070;Castellserà;1003;506;497
25;Lleida;071;Cava;47;29;18
25;Lleida;072;Cervera;9180;4670;4510
25;Lleida;073;Cervià de les Garrigues;640;336;304
25;Lleida;074;Ciutadilla;208;111;97
25;Lleida;075;Clariana de Cardener;157;82;75
25;Lleida;076;Cogul, El;158;88;70
25;Lleida;077;Coll de Nargó;550;285;265
25;Lleida;163;Coma i la Pedra, La;265;157;108
25;Lleida;161;Conca de Dalt;418;213;205
25;Lleida;078;Corbins;1444;787;657
25;Lleida;079;Cubells;343;180;163
25;Lleida;081;Espluga Calba, L';341;171;170
25;Lleida;082;Espot;364;193;171
25;Lleida;088;Estamariu;118;68;50
25;Lleida;085;Estaràs;162;85;77
25;Lleida;086;Esterri d'Àneu;772;364;408
25;Lleida;087;Esterri de Cardós;70;37;33
25;Lleida;089;Farrera;116;65;51
25;Lleida;908;Fígols i Alinyà;252;145;107
25;Lleida;092;Floresta, La;147;79;68
25;Lleida;093;Fondarella;784;387;397
25;Lleida;094;Foradada;186;108;78
25;Lleida;096;Fuliola, La;1248;619;629
25;Lleida;097;Fulleda;85;44;41
25;Lleida;098;Gavet de la Conca;261;129;132
25;Lleida;912;Gimenells i el Pla de la Font;1111;595;516
25;Lleida;099;Golmés;1840;917;923
25;Lleida;100;Gósol;206;118;88
25;Lleida;101;Granadella, La;712;387;325
25;Lleida;102;Granja d'Escarp, La;936;514;422
25;Lleida;103;Granyanella;148;82;66
25;Lleida;105;Granyena de les Garrigues;132;78;54
25;Lleida;104;Granyena de Segarra;142;76;66
25;Lleida;109;Guimerà;265;140;125
25;Lleida;903;Guingueta d'Àneu, La;297;159;138
25;Lleida;110;Guissona;7136;3810;3326
25;Lleida;111;Guixers;134;84;50
25;Lleida;115;Isona i Conca Dellà;1019;548;471
25;Lleida;112;Ivars de Noguera;334;171;163
25;Lleida;113;Ivars d'Urgell;1531;801;730
25;Lleida;114;Ivorra;104;57;47
25;Lleida;910;Josa i Tuixén;106;58;48
25;Lleida;118;Juncosa;386;204;182
25;Lleida;119;Juneda;3475;1854;1621
25;Lleida;121;Les;946;463;483
25;Lleida;122;Linyola;2700;1365;1335
25;Lleida;123;Lladorre;230;116;114
25;Lleida;124;Lladurs;176;91;85
25;Lleida;125;Llardecans;451;236;215
25;Lleida;126;Llavorsí;352;180;172
25;Lleida;120;Lleida;138956;68657;70299
25;Lleida;127;Lles de Cerdanya;253;148;105
25;Lleida;128;Llimiana;145;88;57
25;Lleida;129;Llobera;188;104;84
25;Lleida;133;Maials;920;517;403
25;Lleida;130;Maldà;220;109;111
25;Lleida;131;Massalcoreig;598;338;260
25;Lleida;132;Massoteres;218;119;99
25;Lleida;134;Menàrguens;806;440;366
25;Lleida;135;Miralcamp;1351;677;674
25;Lleida;137;Mollerussa;14683;7543;7140
25;Lleida;136;Molsosa, La;107;53;54
25;Lleida;139;Montellà i Martinet;579;324;255
25;Lleida;140;Montferrer i Castellbò;1041;566;475
25;Lleida;138;Montgai;625;329;296
25;Lleida;142;Montoliu de Lleida;489;251;238
25;Lleida;141;Montoliu de Segarra;179;100;79
25;Lleida;143;Montornès de Segarra;100;47;53
25;Lleida;145;Nalec;87;45;42
25;Lleida;025;Naut Aran;1803;935;868
25;Lleida;146;Navès;280;147;133
25;Lleida;148;Odèn;249;149;100
25;Lleida;149;Oliana;1810;906;904
25;Lleida;150;Oliola;197;106;91
25;Lleida;151;Olius;986;527;459
25;Lleida;152;Oluges, Les;167;88;79
25;Lleida;153;Omellons, Els;211;111;100
25;Lleida;154;Omells de na Gaia, Els;131;72;59
25;Lleida;155;Organyà;784;388;396
25;Lleida;156;Os de Balaguer;994;507;487
25;Lleida;157;Ossó de Sió;204;98;106
25;Lleida;158;Palau d'Anglesola, El;2166;1061;1105
25;Lleida;164;Penelles;452;262;190
25;Lleida;165;Peramola;347;177;170
25;Lleida;166;Pinell de Solsonès;200;118;82
25;Lleida;167;Pinós;287;151;136
25;Lleida;911;Plans de Sió, Els;506;272;234
25;Lleida;168;Poal, El;648;340;308
25;Lleida;169;Pobla de Cérvoles, La;191;107;84
25;Lleida;171;Pobla de Segur, La;2984;1469;1515
25;Lleida;030;Pont de Bar, El;157;87;70
25;Lleida;173;Pont de Suert, El;2220;1107;1113
25;Lleida;172;Ponts;2601;1305;1296
25;Lleida;174;Portella, La;728;412;316
25;Lleida;175;Prats i Sansor;219;114;105
25;Lleida;176;Preixana;385;199;186
25;Lleida;177;Preixens;432;218;214
25;Lleida;179;Prullans;231;109;122
25;Lleida;180;Puiggròs;276;138;138
25;Lleida;181;Puigverd d'Agramunt;255;146;109
25;Lleida;182;Puigverd de Lleida;1355;701;654
25;Lleida;183;Rialp;661;330;331
25;Lleida;905;Ribera d'Ondara;426;213;213
25;Lleida;185;Ribera d'Urgellet;935;488;447
25;Lleida;186;Riner;263;132;131
25;Lleida;913;Riu de Cerdanya;93;55;38
25;Lleida;189;Rosselló;3145;1602;1543
25;Lleida;190;Salàs de Pallars;320;174;146
25;Lleida;191;Sanaüja;380;202;178
25;Lleida;196;Sant Esteve de la Sarga;124;72;52
25;Lleida;192;Sant Guim de Freixenet;1025;538;487
25;Lleida;197;Sant Guim de la Plana;185;106;79
25;Lleida;193;Sant Llorenç de Morunys;949;457;492
25;Lleida;902;Sant Martí de Riucorb;646;334;312
25;Lleida;194;Sant Ramon;491;254;237
25;Lleida;201;Sarroca de Bellera;121;68;53
25;Lleida;200;Sarroca de Lleida;363;200;163
25;Lleida;202;Senterada;137;80;57
25;Lleida;035;Sentiu de Sió, La;406;216;190
25;Lleida;204;Seròs;1922;1029;893
25;Lleida;203;Seu d'Urgell, La;12089;5842;6247
25;Lleida;205;Sidamon;734;383;351
25;Lleida;206;Soleràs, El;332;173;159
25;Lleida;207;Solsona;9094;4488;4606
25;Lleida;208;Soriguera;410;220;190
25;Lleida;209;Sort;2149;1077;1072
25;Lleida;210;Soses;1763;923;840
25;Lleida;211;Sudanell;853;465;388
25;Lleida;212;Sunyer;352;205;147
25;Lleida;215;Talarn;585;387;198
25;Lleida;216;Talavera;283;158;125
25;Lleida;217;Tàrrega;17098;8489;8609
25;Lleida;218;Tarrés;106;56;50
25;Lleida;219;Tarroja de Segarra;187;104;83
25;Lleida;220;Térmens;1333;678;655
25;Lleida;221;Tírvia;131;63;68
25;Lleida;222;Tiurana;73;33;40
25;Lleida;223;Torà;1255;639;616
25;Lleida;224;Torms, Els;144;77;67
25;Lleida;225;Tornabous;858;461;397
25;Lleida;227;Torre de Cabdella, La;760;383;377
25;Lleida;226;Torrebesses;282;150;132
25;Lleida;228;Torrefarrera;4605;2328;2277
25;Lleida;907;Torrefeta i Florejacs;602;322;280
25;Lleida;230;Torregrossa;2202;1140;1062
25;Lleida;231;Torrelameu;743;433;310
25;Lleida;232;Torres de Segre;2277;1179;1098
25;Lleida;233;Torre-serona;397;208;189
25;Lleida;234;Tremp;5844;2884;2960
25;Lleida;043;Vall de Boí, La;1021;546;475
25;Lleida;901;Vall de Cardós;364;195;169
25;Lleida;238;Vallbona de les Monges;233;120;113
25;Lleida;240;Vallfogona de Balaguer;1876;937;939
25;Lleida;906;Valls d'Aguilar, Les;260;145;115
25;Lleida;239;Valls de Valira, Les;791;412;379
25;Lleida;909;Vansa i Fórnols, La;161;84;77
25;Lleida;242;Verdú;919;441;478
25;Lleida;243;Vielha e Mijaran;5559;2837;2722
25;Lleida;244;Vilagrassa;541;278;263
25;Lleida;245;Vilaller;561;294;267
25;Lleida;247;Vilamòs;187;100;87
25;Lleida;248;Vilanova de Bellpuig;1181;599;582
25;Lleida;254;Vilanova de la Barca;1036;535;501
25;Lleida;249;Vilanova de l'Aguda;197;97;100
25;Lleida;250;Vilanova de Meià;389;223;166
25;Lleida;251;Vilanova de Segrià;977;518;459
25;Lleida;252;Vila-sana;742;376;366
25;Lleida;253;Vilosell, El;169;88;81
25;Lleida;255;Vinaixa;470;249;221
27;Lugo;001;Abadín;2367;1157;1210
27;Lugo;002;Alfoz;1688;812;876
27;Lugo;003;Antas de Ulla;1976;966;1010
27;Lugo;004;Baleira;1241;660;581
27;Lugo;901;Baralla;2556;1351;1205
27;Lugo;005;Barreiros;2934;1405;1529
27;Lugo;006;Becerreá;2818;1419;1399
27;Lugo;007;Begonte;3026;1516;1510
27;Lugo;008;Bóveda;1481;768;713
27;Lugo;902;Burela;9588;4754;4834
27;Lugo;009;Carballedo;2193;1102;1091
27;Lugo;010;Castro de Rei;5052;2496;2556
27;Lugo;011;Castroverde;2617;1355;1262
27;Lugo;012;Cervantes;1338;762;576
27;Lugo;013;Cervo;4227;2076;2151
27;Lugo;016;Chantada;8192;3943;4249
27;Lugo;014;Corgo, O;3481;1773;1708
27;Lugo;015;Cospeito;4484;2180;2304
27;Lugo;017;Folgoso do Courel;1024;530;494
27;Lugo;018;Fonsagrada, A;3465;1816;1649
27;Lugo;019;Foz;9980;4863;5117
27;Lugo;020;Friol;3744;1888;1856
27;Lugo;022;Guitiriz;5484;2730;2754
27;Lugo;023;Guntín;2690;1381;1309
27;Lugo;024;Incio, O;1570;791;779
27;Lugo;026;Láncara;2605;1332;1273
27;Lugo;027;Lourenzá;2140;1040;1100
27;Lugo;028;Lugo;98276;45508;52768
27;Lugo;029;Meira;1725;865;860
27;Lugo;030;Mondoñedo;3568;1681;1887
27;Lugo;031;Monforte de Lemos;18433;8751;9682
27;Lugo;032;Monterroso;3616;1812;1804
27;Lugo;033;Muras;642;316;326
27;Lugo;034;Navia de Suarna;1081;600;481
27;Lugo;035;Negueira de Muñiz;215;114;101
27;Lugo;037;Nogais, As;1079;575;504
27;Lugo;038;Ourol;1018;521;497
27;Lugo;039;Outeiro de Rei;5151;2655;2496
27;Lugo;040;Palas de Rei;3388;1712;1676
27;Lugo;041;Pantón;2542;1246;1296
27;Lugo;042;Paradela;1779;885;894
27;Lugo;043;Páramo, O;1366;681;685
27;Lugo;044;Pastoriza, A;3002;1513;1489
27;Lugo;045;Pedrafita do Cebreiro;1001;545;456
27;Lugo;047;Pobra do Brollón, A;1648;815;833
27;Lugo;046;Pol;1609;808;801
27;Lugo;048;Pontenova, A;2264;1082;1182
27;Lugo;049;Portomarín;1471;761;710
27;Lugo;050;Quiroga;3207;1523;1684
27;Lugo;056;Rábade;1501;749;752
27;Lugo;051;Ribadeo;9854;4696;5158
27;Lugo;052;Ribas de Sil;947;474;473
27;Lugo;053;Ribeira de Piquín;528;274;254
27;Lugo;054;Riotorto;1262;621;641
27;Lugo;055;Samos;1278;681;597
27;Lugo;057;Sarria;13330;6492;6838
27;Lugo;058;Saviñao, O;3735;1892;1843
27;Lugo;059;Sober;2312;1137;1175
27;Lugo;060;Taboada;2756;1311;1445
27;Lugo;061;Trabada;1118;546;572
27;Lugo;062;Triacastela;641;317;324
27;Lugo;063;Valadouro, O;1991;957;1034
27;Lugo;064;Vicedo, O;1675;821;854
27;Lugo;065;Vilalba;14072;6817;7255
27;Lugo;066;Viveiro;15466;7559;7907
27;Lugo;021;Xermade;1806;882;924
27;Lugo;025;Xove;3273;1625;1648
28;Madrid;001;Acebeda, La;84;44;40
28;Madrid;002;Ajalvir;4712;2438;2274
28;Madrid;003;Alameda del Valle;200;119;81
28;Madrid;004;Álamo, El;9470;4696;4774
28;Madrid;005;Alcalá de Henares;195649;95234;100415
28;Madrid;006;Alcobendas;117040;55954;61086
28;Madrid;007;Alcorcón;170514;82139;88375
28;Madrid;008;Aldea del Fresno;2838;1457;1381
28;Madrid;009;Algete;20611;10106;10505
28;Madrid;010;Alpedrete;14575;7160;7415
28;Madrid;011;Ambite;592;296;296
28;Madrid;012;Anchuelo;1271;657;614
28;Madrid;013;Aranjuez;59607;28978;30629
28;Madrid;014;Arganda del Rey;55389;27771;27618
28;Madrid;015;Arroyomolinos;31396;15701;15695
28;Madrid;016;Atazar, El;89;48;41
28;Madrid;017;Batres;1684;861;823
28;Madrid;018;Becerril de la Sierra;5714;2877;2837
28;Madrid;019;Belmonte de Tajo;1664;865;799
28;Madrid;021;Berrueco, El;760;384;376
28;Madrid;020;Berzosa del Lozoya;205;115;90
28;Madrid;022;Boadilla del Monte;54570;26660;27910
28;Madrid;023;Boalo, El;7508;3757;3751
28;Madrid;024;Braojos;205;121;84
28;Madrid;025;Brea de Tajo;524;301;223
28;Madrid;026;Brunete;10736;5283;5453
28;Madrid;027;Buitrago del Lozoya;1884;898;986
28;Madrid;028;Bustarviejo;2503;1256;1247
28;Madrid;029;Cabanillas de la Sierra;756;392;364
28;Madrid;030;Cabrera, La;2667;1313;1354
28;Madrid;031;Cadalso de los Vidrios;3039;1593;1446
28;Madrid;032;Camarma de Esteruelas;7336;3726;3610
28;Madrid;033;Campo Real;6210;3138;3072
28;Madrid;034;Canencia;447;245;202
28;Madrid;035;Carabaña;2010;1002;1008
28;Madrid;036;Casarrubuelos;3778;1923;1855
28;Madrid;037;Cenicientos;2033;1004;1029
28;Madrid;038;Cercedilla;7026;3463;3563
28;Madrid;039;Cervera de Buitrago;150;92;58
28;Madrid;051;Chapinería;2328;1181;1147
28;Madrid;052;Chinchón;5331;2682;2649
28;Madrid;040;Ciempozuelos;24592;12363;12229
28;Madrid;041;Cobeña;7428;3623;3805
28;Madrid;046;Collado Mediano;6958;3441;3517
28;Madrid;047;Collado Villalba;63679;30947;32732
28;Madrid;043;Colmenar de Oreja;8032;4052;3980
28;Madrid;042;Colmenar del Arroyo;1725;893;832
28;Madrid;045;Colmenar Viejo;50752;25045;25707
28;Madrid;044;Colmenarejo;9130;4471;4659
28;Madrid;048;Corpa;713;372;341
28;Madrid;049;Coslada;81661;39988;41673
28;Madrid;050;Cubas de la Sagra;6413;3202;3211
28;Madrid;053;Daganzo de Arriba;10205;5079;5126
28;Madrid;054;Escorial, El;16162;8004;8158
28;Madrid;055;Estremera;1260;637;623
28;Madrid;056;Fresnedillas de la Oliva;1572;797;775
28;Madrid;057;Fresno de Torote;2221;1164;1057
28;Madrid;058;Fuenlabrada;193700;95409;98291
28;Madrid;059;Fuente el Saz de Jarama;6696;3379;3317
28;Madrid;060;Fuentidueña de Tajo;2053;1023;1030
28;Madrid;061;Galapagar;33742;16470;17272
28;Madrid;062;Garganta de los Montes;347;189;158
28;Madrid;063;Gargantilla del Lozoya y Pinilla de Buitrago;316;170;146
28;Madrid;064;Gascones;193;110;83
28;Madrid;065;Getafe;183374;89701;93673
28;Madrid;066;Griñón;10319;5157;5162
28;Madrid;067;Guadalix de la Sierra;6214;3136;3078
28;Madrid;068;Guadarrama;16032;7921;8111
28;Madrid;069;Hiruela, La;57;39;18
28;Madrid;070;Horcajo de la Sierra-Aoslos;145;78;67
28;Madrid;071;Horcajuelo de la Sierra;86;47;39
28;Madrid;072;Hoyo de Manzanares;8434;4226;4208
28;Madrid;073;Humanes de Madrid;19743;9893;9850
28;Madrid;074;Leganés;189861;91999;97862
28;Madrid;075;Loeches;8791;4400;4391
28;Madrid;076;Lozoya;581;309;272
28;Madrid;901;Lozoyuela-Navas-Sieteiglesias;1299;670;629
28;Madrid;078;Madarcos;48;30;18
28;Madrid;079;Madrid;3266126;1520153;1745973
28;Madrid;080;Majadahonda;71826;34018;37808
28;Madrid;082;Manzanares el Real;8840;4474;4366
28;Madrid;083;Meco;14305;7211;7094
28;Madrid;084;Mejorada del Campo;23274;11540;11734
28;Madrid;085;Miraflores de la Sierra;6108;3133;2975
28;Madrid;086;Molar, El;8938;4557;4381
28;Madrid;087;Molinos, Los;4389;2160;2229
28;Madrid;088;Montejo de la Sierra;353;178;175
28;Madrid;089;Moraleja de Enmedio;5136;2548;2588
28;Madrid;090;Moralzarzal;13026;6527;6499
28;Madrid;091;Morata de Tajuña;7683;3836;3847
28;Madrid;092;Móstoles;209184;101905;107279
28;Madrid;093;Navacerrada;2972;1493;1479
28;Madrid;094;Navalafuente;1449;744;705
28;Madrid;095;Navalagamella;2610;1350;1260
28;Madrid;096;Navalcarnero;29298;14585;14713
28;Madrid;097;Navarredonda y San Mamés;129;84;45
28;Madrid;099;Navas del Rey;2918;1535;1383
28;Madrid;100;Nuevo Baztán;6276;3191;3085
28;Madrid;101;Olmeda de las Fuentes;348;185;163
28;Madrid;102;Orusco de Tajuña;1244;637;607
28;Madrid;104;Paracuellos de Jarama;25269;12703;12566
28;Madrid;106;Parla;130124;64802;65322
28;Madrid;107;Patones;541;254;287
28;Madrid;108;Pedrezuela;5892;2936;2956
28;Madrid;109;Pelayos de la Presa;2596;1316;1280
28;Madrid;110;Perales de Tajuña;2935;1480;1455
28;Madrid;111;Pezuela de las Torres;842;449;393
28;Madrid;112;Pinilla del Valle;191;109;82
28;Madrid;113;Pinto;52526;25964;26562
28;Madrid;114;Piñuécar-Gandullas;185;95;90
28;Madrid;115;Pozuelo de Alarcón;86422;41354;45068
28;Madrid;116;Pozuelo del Rey;1147;603;544
28;Madrid;117;Prádena del Rincón;117;65;52
28;Madrid;118;Puebla de la Sierra;65;38;27
28;Madrid;902;Puentes Viejas;679;378;301
28;Madrid;119;Quijorna;3439;1720;1719
28;Madrid;120;Rascafría;1664;918;746
28;Madrid;121;Redueña;260;141;119
28;Madrid;122;Ribatejada;783;399;384
28;Madrid;123;Rivas-Vaciamadrid;88150;43696;44454
28;Madrid;124;Robledillo de la Jara;80;44;36
28;Madrid;125;Robledo de Chavela;4270;2213;2057
28;Madrid;126;Robregordo;58;35;23
28;Madrid;127;Rozas de Madrid, Las;95814;46285;49529
28;Madrid;128;Rozas de Puerto Real;530;306;224
28;Madrid;129;San Agustín del Guadalix;13379;6565;6814
28;Madrid;130;San Fernando de Henares;39432;19180;20252
28;Madrid;131;San Lorenzo de El Escorial;18369;8803;9566
28;Madrid;132;San Martín de la Vega;19170;9808;9362
28;Madrid;133;San Martín de Valdeiglesias;8459;4204;4255
28;Madrid;134;San Sebastián de los Reyes;89276;43550;45726
28;Madrid;135;Santa María de la Alameda;1254;665;589
28;Madrid;136;Santorcaz;886;467;419
28;Madrid;137;Santos de la Humosa, Los;2590;1320;1270
28;Madrid;138;Serna del Monte, La;81;42;39
28;Madrid;140;Serranillos del Valle;4165;2060;2105
28;Madrid;141;Sevilla la Nueva;9318;4546;4772
28;Madrid;143;Somosierra;86;50;36
28;Madrid;144;Soto del Real;8799;4302;4497
28;Madrid;145;Talamanca de Jarama;3857;1906;1951
28;Madrid;146;Tielmes;2650;1353;1297
28;Madrid;147;Titulcia;1313;686;627
28;Madrid;148;Torrejón de Ardoz;131376;64749;66627
28;Madrid;149;Torrejón de la Calzada;8872;4385;4487
28;Madrid;150;Torrejón de Velasco;4382;2181;2201
28;Madrid;151;Torrelaguna;4760;2388;2372
28;Madrid;152;Torrelodones;23717;11465;12252
28;Madrid;153;Torremocha de Jarama;1019;514;505
28;Madrid;154;Torres de la Alameda;7779;3973;3806
28;Madrid;903;Tres Cantos;47722;23141;24581
28;Madrid;155;Valdaracete;609;313;296
28;Madrid;156;Valdeavero;1554;806;748
28;Madrid;157;Valdelaguna;937;469;468
28;Madrid;158;Valdemanco;914;480;434
28;Madrid;159;Valdemaqueda;781;405;376
28;Madrid;160;Valdemorillo;12518;6306;6212
28;Madrid;161;Valdemoro;75983;37493;38490
28;Madrid;162;Valdeolmos-Alalpardo;4136;2130;2006
28;Madrid;163;Valdepiélagos;584;315;269
28;Madrid;164;Valdetorres de Jarama;4497;2277;2220
28;Madrid;165;Valdilecha;2933;1517;1416
28;Madrid;166;Valverde de Alcalá;465;239;226
28;Madrid;167;Velilla de San Antonio;12236;6178;6058
28;Madrid;168;Vellón, El;1958;1022;936
28;Madrid;169;Venturada;2163;1135;1028
28;Madrid;171;Villa del Prado;6520;3309;3211
28;Madrid;170;Villaconejos;3388;1745;1643
28;Madrid;172;Villalbilla;13878;7002;6876
28;Madrid;173;Villamanrique de Tajo;703;352;351
28;Madrid;174;Villamanta;2555;1299;1256
28;Madrid;175;Villamantilla;1441;709;732
28;Madrid;176;Villanueva de la Cañada;21445;10430;11015
28;Madrid;178;Villanueva de Perales;1563;801;762
28;Madrid;177;Villanueva del Pardillo;17180;8389;8791
28;Madrid;179;Villar del Olmo;2011;1003;1008
28;Madrid;180;Villarejo de Salvanés;7335;3692;3643
28;Madrid;181;Villaviciosa de Odón;27835;13493;14342
28;Madrid;182;Villavieja del Lozoya;253;136;117
28;Madrid;183;Zarzalejo;1658;853;805
29;Málaga;001;Alameda;5372;2735;2637
29;Málaga;002;Alcaucín;2230;1140;1090
29;Málaga;003;Alfarnate;1069;546;523
29;Málaga;004;Alfarnatejo;377;193;184
29;Málaga;005;Algarrobo;6444;3238;3206
29;Málaga;006;Algatocín;793;410;383
29;Málaga;007;Alhaurín de la Torre;40345;20047;20298
29;Málaga;008;Alhaurín el Grande;24705;12344;12361
29;Málaga;009;Almáchar;1811;944;867
29;Málaga;010;Almargen;1954;995;959
29;Málaga;011;Almogía;3715;1922;1793
29;Málaga;012;Álora;12985;6572;6413
29;Málaga;013;Alozaina;2051;1050;1001
29;Málaga;014;Alpandeire;260;131;129
29;Málaga;015;Antequera;41239;20180;21059
29;Málaga;016;Árchez;385;202;183
29;Málaga;017;Archidona;8238;4213;4025
29;Málaga;018;Ardales;2500;1273;1227
29;Málaga;019;Arenas;1156;611;545
29;Málaga;020;Arriate;4102;2033;2069
29;Málaga;021;Atajate;168;91;77
29;Málaga;022;Benadalid;215;108;107
29;Málaga;023;Benahavís;8085;4043;4042
29;Málaga;024;Benalauría;438;231;207
29;Málaga;025;Benalmádena;68128;33521;34607
29;Málaga;026;Benamargosa;1514;788;726
29;Málaga;027;Benamocarra;3011;1509;1502
29;Málaga;028;Benaoján;1476;765;711
29;Málaga;029;Benarrabá;455;230;225
29;Málaga;030;Borge, El;930;483;447
29;Málaga;031;Burgo, El;1800;929;871
29;Málaga;032;Campillos;8444;4270;4174
29;Málaga;033;Canillas de Aceituno;1677;890;787
29;Málaga;034;Canillas de Albaida;716;355;361
29;Málaga;035;Cañete la Real;1665;846;819
29;Málaga;036;Carratraca;731;383;348
29;Málaga;037;Cartajima;253;136;117
29;Málaga;038;Cártama;26259;13266;12993
29;Málaga;039;Casabermeja;3522;1844;1678
29;Málaga;040;Casarabonela;2502;1336;1166
29;Málaga;041;Casares;6515;3355;3160
29;Málaga;042;Coín;22147;11094;11053
29;Málaga;043;Colmenar;3376;1728;1648
29;Málaga;044;Comares;1315;704;611
29;Málaga;045;Cómpeta;3922;1958;1964
29;Málaga;046;Cortes de la Frontera;3101;1592;1509
29;Málaga;047;Cuevas Bajas;1395;696;699
29;Málaga;049;Cuevas de San Marcos;3648;1838;1810
29;Málaga;048;Cuevas del Becerro;1589;785;804
29;Málaga;050;Cútar;607;309;298
29;Málaga;051;Estepona;68286;33508;34778
29;Málaga;052;Faraján;253;124;129
29;Málaga;053;Frigiliana;3009;1503;1506
29;Málaga;054;Fuengirola;80309;39217;41092
29;Málaga;055;Fuente de Piedra;2596;1330;1266
29;Málaga;056;Gaucín;1576;820;756
29;Málaga;057;Genalguacil;410;205;205
29;Málaga;058;Guaro;2260;1137;1123
29;Málaga;059;Humilladero;3286;1630;1656
29;Málaga;060;Igualeja;763;381;382
29;Málaga;061;Istán;1469;732;737
29;Málaga;062;Iznate;868;453;415
29;Málaga;063;Jimera de Líbar;372;192;180
29;Málaga;064;Jubrique;528;266;262
29;Málaga;065;Júzcar;232;133;99
29;Málaga;066;Macharaviaya;480;259;221
29;Málaga;067;Málaga;574654;276001;298653
29;Málaga;068;Manilva;15528;7856;7672
29;Málaga;069;Marbella;143386;68944;74442
29;Málaga;070;Mijas;82742;41196;41546
29;Málaga;071;Moclinejo;1271;657;614
29;Málaga;072;Mollina;5149;2585;2564
29;Málaga;073;Monda;2594;1336;1258
29;Málaga;903;Montecorto;593;317;276
29;Málaga;074;Montejaque;964;478;486
29;Málaga;075;Nerja;21091;10410;10681
29;Málaga;076;Ojén;3702;1888;1814
29;Málaga;077;Parauta;251;126;125
29;Málaga;079;Periana;3048;1602;1446
29;Málaga;080;Pizarra;9226;4636;4590
29;Málaga;081;Pujerra;301;158;143
29;Málaga;082;Rincón de la Victoria;47179;23163;24016
29;Málaga;083;Riogordo;2724;1429;1295
29;Málaga;084;Ronda;33877;16427;17450
29;Málaga;085;Salares;169;87;82
29;Málaga;086;Sayalonga;1681;863;818
29;Málaga;087;Sedella;606;341;265
29;Málaga;904;Serrato;477;240;237
29;Málaga;088;Sierra de Yeguas;3346;1690;1656
29;Málaga;089;Teba;3760;1887;1873
29;Málaga;090;Tolox;2107;1061;1046
29;Málaga;901;Torremolinos;68661;34276;34385
29;Málaga;091;Torrox;17234;8704;8530
29;Málaga;092;Totalán;746;380;366
29;Málaga;093;Valle de Abdalajís;2542;1292;1250
29;Málaga;094;Vélez-Málaga;81643;40239;41404
29;Málaga;095;Villanueva de Algaidas;4176;2143;2033
29;Málaga;902;Villanueva de la Concepción;3296;1612;1684
29;Málaga;098;Villanueva de Tapia;1476;744;732
29;Málaga;096;Villanueva del Rosario;3356;1649;1707
29;Málaga;097;Villanueva del Trabuco;5299;2659;2640
29;Málaga;099;Viñuela;2034;1061;973
29;Málaga;100;Yunquera;2864;1460;1404
52;Melilla;001;Melilla;86487;43894;42593
30;Murcia;001;Abanilla;6127;3112;3015
30;Murcia;002;Abarán;12964;6479;6485
30;Murcia;003;Águilas;35301;17620;17681
30;Murcia;004;Albudeite;1373;694;679
30;Murcia;005;Alcantarilla;42048;20794;21254
30;Murcia;902;Alcázares, Los;16138;8238;7900
30;Murcia;006;Aledo;1022;505;517
30;Murcia;007;Alguazas;9638;4957;4681
30;Murcia;008;Alhama de Murcia;22077;11168;10909
30;Murcia;009;Archena;19301;10155;9146
30;Murcia;010;Beniel;11318;5848;5470
30;Murcia;011;Blanca;6539;3328;3211
30;Murcia;012;Bullas;11530;5795;5735
30;Murcia;013;Calasparra;10178;5147;5031
30;Murcia;014;Campos del Río;2028;956;1072
30;Murcia;015;Caravaca de la Cruz;25760;12903;12857
30;Murcia;016;Cartagena;214802;106951;107851
30;Murcia;017;Cehegín;14983;7537;7446
30;Murcia;018;Ceutí;11787;5938;5849
30;Murcia;019;Cieza;34988;17533;17455
30;Murcia;020;Fortuna;10112;5412;4700
30;Murcia;021;Fuente Álamo de Murcia;16583;8611;7972
30;Murcia;022;Jumilla;25600;13305;12295
30;Murcia;023;Librilla;5305;2728;2577
30;Murcia;024;Lorca;94404;48331;46073
30;Murcia;025;Lorquí;7141;3611;3530
30;Murcia;026;Mazarrón;32209;16654;15555
30;Murcia;027;Molina de Segura;71890;35862;36028
30;Murcia;028;Moratalla;7839;3978;3861
30;Murcia;029;Mula;16883;8671;8212
30;Murcia;030;Murcia;453258;221543;231715
30;Murcia;031;Ojós;500;260;240
30;Murcia;032;Pliego;3847;1991;1856
30;Murcia;033;Puerto Lumbreras;15394;7778;7616
30;Murcia;034;Ricote;1264;675;589
30;Murcia;035;San Javier;32489;16318;16171
30;Murcia;036;San Pedro del Pinatar;25476;12828;12648
30;Murcia;901;Santomera;16206;8124;8082
30;Murcia;037;Torre-Pacheco;35676;18477;17199
30;Murcia;038;Torres de Cotillas, Las;21471;10909;10562
30;Murcia;039;Totana;32008;16455;15553
30;Murcia;040;Ulea;874;453;421
30;Murcia;041;Unión, La;20225;10271;9954
30;Murcia;042;Villanueva del Río Segura;2910;1445;1465
30;Murcia;043;Yecla;34432;17267;17165
31;Navarra;001;Abáigar;83;48;35
31;Navarra;002;Abárzuza/Abartzuza;538;265;273
31;Navarra;003;Abaurregaina/Abaurrea Alta;126;77;49
31;Navarra;004;Abaurrepea/Abaurrea Baja;32;19;13
31;Navarra;005;Aberin;359;193;166
31;Navarra;006;Ablitas;2481;1252;1229
31;Navarra;007;Adiós;155;87;68
31;Navarra;008;Aguilar de Codés;67;39;28
31;Navarra;009;Aibar/Oibar;805;425;380
31;Navarra;011;Allín/Allin;872;465;407
31;Navarra;012;Allo;968;481;487
31;Navarra;010;Altsasu/Alsasua;7443;3761;3682
31;Navarra;013;Améscoa Baja;724;393;331
31;Navarra;014;Ancín/Antzin;337;192;145
31;Navarra;015;Andosilla;2743;1397;1346
31;Navarra;016;Ansoáin/Antsoain;10833;5312;5521
31;Navarra;017;Anue;482;257;225
31;Navarra;018;Añorbe;581;317;264
31;Navarra;019;Aoiz/Agoitz;2695;1376;1319
31;Navarra;020;Araitz;512;285;227
31;Navarra;025;Arakil;933;487;446
31;Navarra;021;Aranarache/Aranaratxe;72;42;30
31;Navarra;023;Aranguren;10859;5468;5391
31;Navarra;024;Arano;116;63;53
31;Navarra;022;Arantza;597;316;281
31;Navarra;026;Aras;153;81;72
31;Navarra;027;Arbizu;1104;565;539
31;Navarra;028;Arce/Artzi;262;138;124
31;Navarra;029;Arcos, Los;1134;558;576
31;Navarra;030;Arellano;157;85;72
31;Navarra;031;Areso;279;142;137
31;Navarra;032;Arguedas;2272;1155;1117
31;Navarra;033;Aria;51;29;22
31;Navarra;034;Aribe;33;19;14
31;Navarra;035;Armañanzas;53;28;25
31;Navarra;036;Arróniz;1051;559;492
31;Navarra;037;Arruazu;110;58;52
31;Navarra;038;Artajona;1675;854;821
31;Navarra;039;Artazu;116;61;55
31;Navarra;040;Atez/Atetz;215;119;96
31;Navarra;058;Auritz/Burguete;231;118;113
31;Navarra;041;Ayegui/Aiegi;2366;1230;1136
31;Navarra;042;Azagra;3843;1947;1896
31;Navarra;043;Azuelo;31;12;19
31;Navarra;044;Bakaiku;362;188;174
31;Navarra;901;Barañáin/Barañain;20199;9772;10427
31;Navarra;045;Barásoain;621;329;292
31;Navarra;046;Barbarin;55;27;28
31;Navarra;047;Bargota;257;123;134
31;Navarra;048;Barillas;214;115;99
31;Navarra;049;Basaburua;834;479;355
31;Navarra;050;Baztan;7777;3929;3848
31;Navarra;137;Beintza-Labaien;220;128;92
31;Navarra;051;Beire;286;151;135
31;Navarra;052;Belascoáin;122;62;60
31;Navarra;250;Bera;3736;1830;1906
31;Navarra;053;Berbinzana;655;332;323
31;Navarra;905;Beriáin;4069;2018;2051
31;Navarra;902;Berrioplano/Berriobeiti;7256;3696;3560
31;Navarra;903;Berriozar;10426;5251;5175
31;Navarra;054;Bertizarana;612;302;310
31;Navarra;055;Betelu;366;191;175
31;Navarra;253;Bidaurreta;163;89;74
31;Navarra;056;Biurrun-Olcoz;214;120;94
31;Navarra;057;Buñuel;2219;1081;1138
31;Navarra;059;Burgui/Burgi;207;119;88
31;Navarra;060;Burlada/Burlata;19096;9223;9873
31;Navarra;061;Busto, El;56;27;29
31;Navarra;062;Cabanillas;1357;717;640
31;Navarra;063;Cabredo;91;49;42
31;Navarra;064;Cadreita;1964;1008;956
31;Navarra;065;Caparroso;2766;1458;1308
31;Navarra;066;Cárcar;1069;541;528
31;Navarra;067;Carcastillo;2495;1269;1226
31;Navarra;068;Cascante;3864;1937;1927
31;Navarra;069;Cáseda;974;489;485
31;Navarra;070;Castejón;4163;2090;2073
31;Navarra;071;Castillonuevo;16;11;5
31;Navarra;193;Cendea de Olza/Oltza Zendea;1831;901;930
31;Navarra;072;Cintruénigo;7903;4071;3832
31;Navarra;074;Cirauqui/Zirauki;487;254;233
31;Navarra;075;Ciriza/Ziritza;155;72;83
31;Navarra;076;Cizur;3888;1999;1889
31;Navarra;077;Corella;7971;4007;3964
31;Navarra;078;Cortes;3151;1598;1553
31;Navarra;079;Desojo;79;44;35
31;Navarra;080;Dicastillo;604;305;299
31;Navarra;081;Donamaria;433;218;215
31;Navarra;221;Doneztebe/Santesteban;1726;880;846
31;Navarra;083;Echarri/Etxarri;75;36;39
31;Navarra;087;Elgorriaga;220;111;109
31;Navarra;089;Enériz/Eneritz;286;147;139
31;Navarra;090;Eratsun;151;92;59
31;Navarra;091;Ergoiena;372;202;170
31;Navarra;092;Erro;800;449;351
31;Navarra;094;Eslava;111;51;60
31;Navarra;095;Esparza de Salazar/Espartza Zaraitzu;74;40;34
31;Navarra;096;Espronceda;104;58;46
31;Navarra;097;Estella-Lizarra;13810;6608;7202
31;Navarra;098;Esteribar;2702;1396;1306
31;Navarra;099;Etayo;58;31;27
31;Navarra;082;Etxalar;813;427;386
31;Navarra;084;Etxarri Aranatz;2483;1290;1193
31;Navarra;085;Etxauri;650;331;319
31;Navarra;100;Eulate;284;158;126
31;Navarra;101;Ezcabarte;1805;944;861
31;Navarra;093;Ezcároz/Ezkaroze;306;166;140
31;Navarra;102;Ezkurra;146;95;51
31;Navarra;103;Ezprogui;43;23;20
31;Navarra;104;Falces;2315;1185;1130
31;Navarra;105;Fitero;2011;1005;1006
31;Navarra;106;Fontellas;996;501;495
31;Navarra;107;Funes;2440;1285;1155
31;Navarra;108;Fustiñana;2490;1236;1254
31;Navarra;109;Galar;2273;1193;1080
31;Navarra;110;Gallipienzo/Galipentzu;98;55;43
31;Navarra;111;Gallués/Galoze;93;63;30
31;Navarra;112;Garaioa;91;51;40
31;Navarra;113;Garde;139;83;56
31;Navarra;114;Garínoain;499;263;236
31;Navarra;115;Garralda;190;100;90
31;Navarra;116;Genevilla;70;43;27
31;Navarra;117;Goizueta;704;379;325
31;Navarra;118;Goñi;158;103;55
31;Navarra;119;Güesa/Gorza;38;22;16
31;Navarra;120;Guesálaz/Gesalatz;432;254;178
31;Navarra;121;Guirguillano;78;43;35
31;Navarra;256;Hiriberri/Villanueva de Aezkoa;102;54;48
31;Navarra;122;Huarte/Uharte;7101;3580;3521
31;Navarra;124;Ibargoiti;249;148;101
31;Navarra;259;Igantzi;639;339;300
31;Navarra;125;Igúzquiza;325;170;155
31;Navarra;126;Imotz;423;223;200
31;Navarra;127;Irañeta;172;91;81
31;Navarra;904;Irurtzun;2233;1153;1080
31;Navarra;128;Isaba/Izaba;395;196;199
31;Navarra;129;Ituren;511;259;252
31;Navarra;130;Iturmendi;403;208;195
31;Navarra;131;Iza/Itza;1235;666;569
31;Navarra;132;Izagaondoa;176;114;62
31;Navarra;133;Izalzu/Itzaltzu;40;23;17
31;Navarra;134;Jaurrieta;189;107;82
31;Navarra;135;Javier;110;28;82
31;Navarra;136;Juslapeña;563;308;255
31;Navarra;138;Lakuntza;1279;678;601
31;Navarra;139;Lana;169;98;71
31;Navarra;140;Lantz;148;88;60
31;Navarra;141;Lapoblación;120;68;52
31;Navarra;142;Larraga;2075;1088;987
31;Navarra;143;Larraona;102;49;53
31;Navarra;144;Larraun;951;522;429
31;Navarra;145;Lazagurría;189;97;92
31;Navarra;146;Leache/Leatxe;30;17;13
31;Navarra;147;Legarda;117;65;52
31;Navarra;148;Legaria;111;50;61
31;Navarra;149;Leitza;2913;1513;1400
31;Navarra;908;Lekunberri;1536;769;767
31;Navarra;150;Leoz/Leotz;220;142;78
31;Navarra;151;Lerga;55;35;20
31;Navarra;152;Lerín;1725;887;838
31;Navarra;153;Lesaka;2741;1407;1334
31;Navarra;154;Lezaun;242;146;96
31;Navarra;155;Liédena;292;144;148
31;Navarra;156;Lizoáin-Arriasgoiti;295;172;123
31;Navarra;157;Lodosa;4816;2442;2374
31;Navarra;158;Lónguida/Longida;298;159;139
31;Navarra;159;Lumbier;1318;716;602
31;Navarra;160;Luquin;132;70;62
31;Navarra;248;Luzaide/Valcarlos;329;178;151
31;Navarra;161;Mañeru;434;229;205
31;Navarra;162;Marañón;52;26;26
31;Navarra;163;Marcilla;2858;1447;1411
31;Navarra;164;Mélida;733;374;359
31;Navarra;165;Mendavia;3547;1824;1723
31;Navarra;166;Mendaza;287;149;138
31;Navarra;167;Mendigorría;1086;563;523
31;Navarra;168;Metauten;288;156;132
31;Navarra;169;Milagro;3416;1773;1643
31;Navarra;170;Mirafuentes;57;28;29
31;Navarra;171;Miranda de Arga;839;437;402
31;Navarra;172;Monreal/Elo;478;258;220
31;Navarra;173;Monteagudo;1092;545;547
31;Navarra;174;Morentin;129;62;67
31;Navarra;175;Mues;75;43;32
31;Navarra;176;Murchante;4154;2096;2058
31;Navarra;177;Murieta;335;177;158
31;Navarra;178;Murillo el Cuende;665;343;322
31;Navarra;179;Murillo el Fruto;639;346;293
31;Navarra;180;Muruzábal;233;101;132
31;Navarra;181;Navascués/Nabaskoze;132;80;52
31;Navarra;182;Nazar;34;20;14
31;Navarra;088;Noáin (Valle de Elorz)/Noain (Elortzibar);8320;4185;4135
31;Navarra;183;Obanos;935;467;468
31;Navarra;185;Ochagavía/Otsagabia;521;281;240
31;Navarra;184;Oco;77;39;38
31;Navarra;186;Odieta;362;202;160
31;Navarra;187;Oiz;129;79;50
31;Navarra;188;Olaibar;378;220;158
31;Navarra;189;Olazti/Olazagutía;1489;753;736
31;Navarra;190;Olejua;50;27;23
31;Navarra;191;Olite/Erriberri;3946;2001;1945
31;Navarra;192;Olóriz/Oloritz;203;115;88
31;Navarra;195;Orbaizeta;195;97;98
31;Navarra;196;Orbara;33;17;16
31;Navarra;197;Orísoain;79;43;36
31;Navarra;906;Orkoien;4057;2057;2000
31;Navarra;198;Oronz/Orontze;47;24;23
31;Navarra;199;Oroz-Betelu/Orotz-Betelu;146;85;61
31;Navarra;211;Orreaga/Roncesvalles;22;12;10
31;Navarra;200;Oteiza;918;489;429
31;Navarra;201;Pamplona/Iruña;201653;95316;106337
31;Navarra;202;Peralta/Azkoien;5893;2979;2914
31;Navarra;203;Petilla de Aragón;31;17;14
31;Navarra;204;Piedramillera;37;24;13
31;Navarra;205;Pitillas;484;242;242
31;Navarra;206;Puente la Reina/Gares;2840;1424;1416
31;Navarra;207;Pueyo;351;192;159
31;Navarra;208;Ribaforada;3750;1953;1797
31;Navarra;209;Romanzado;175;92;83
31;Navarra;210;Roncal/Erronkari;211;108;103
31;Navarra;212;Sada;133;75;58
31;Navarra;213;Saldías;122;68;54
31;Navarra;214;Salinas de Oro/Jaitz;109;62;47
31;Navarra;215;San Adrián;6292;3116;3176
31;Navarra;217;San Martín de Unx;392;207;185
31;Navarra;216;Sangüesa/Zangoza;4962;2519;2443
31;Navarra;219;Sansol;102;55;47
31;Navarra;220;Santacara;874;456;418
31;Navarra;222;Sarriés/Sartze;58;38;20
31;Navarra;223;Sartaguda;1315;677;638
31;Navarra;224;Sesma;1164;596;568
31;Navarra;225;Sorlada;57;35;22
31;Navarra;226;Sunbilla;675;347;328
31;Navarra;227;Tafalla;10595;5224;5371
31;Navarra;228;Tiebas-Muruarte de Reta;606;315;291
31;Navarra;229;Tirapu;40;25;15
31;Navarra;230;Torralba del Río;103;55;48
31;Navarra;231;Torres del Río;126;62;64
31;Navarra;232;Tudela;36258;17840;18418
31;Navarra;233;Tulebras;128;51;77
31;Navarra;234;Ucar;184;102;82
31;Navarra;123;Uharte Arakil;805;429;376
31;Navarra;235;Ujué/Uxue;182;104;78
31;Navarra;236;Ultzama;1653;851;802
31;Navarra;237;Unciti;211;120;91
31;Navarra;238;Unzué/Untzue;144;78;66
31;Navarra;239;Urdazubi/Urdax;349;170;179
31;Navarra;240;Urdiain;653;335;318
31;Navarra;241;Urraul Alto;133;87;46
31;Navarra;242;Urraul Bajo;322;140;182
31;Navarra;244;Urroz;183;103;80
31;Navarra;243;Urroz-Villa;377;194;183
31;Navarra;245;Urzainqui/Urzainki;84;54;30
31;Navarra;246;Uterga;153;88;65
31;Navarra;247;Uztárroz/Uztarroze;151;79;72
31;Navarra;086;Valle de Egüés/Eguesibar;21128;10611;10517
31;Navarra;194;Valle de Ollo/Ollaran;421;233;188
31;Navarra;260;Valle de Yerri/Deierri;1506;790;716
31;Navarra;249;Valtierra;2412;1216;1196
31;Navarra;251;Viana;4209;2130;2079
31;Navarra;252;Vidángoz/Bidankoze;90;51;39
31;Navarra;254;Villafranca;2847;1438;1409
31;Navarra;255;Villamayor de Monjardín;119;61;58
31;Navarra;257;Villatuerta;1191;597;594
31;Navarra;258;Villava/Atarrabia;10204;4965;5239
31;Navarra;261;Yesa;292;172;120
31;Navarra;262;Zabalza/Zabaltza;297;160;137
31;Navarra;073;Ziordia;348;182;166
31;Navarra;907;Zizur Mayor/Zizur Nagusia;14894;7256;7638
31;Navarra;263;Zubieta;303;157;146
31;Navarra;264;Zugarramurdi;219;108;111
31;Navarra;265;Zúñiga;109;69;40
32;Ourense;001;Allariz;6188;3109;3079
32;Ourense;002;Amoeiro;2280;1140;1140
32;Ourense;003;Arnoia, A;1000;497;503
32;Ourense;004;Avión;1795;825;970
32;Ourense;005;Baltar;962;521;441
32;Ourense;006;Bande;1528;748;780
32;Ourense;007;Baños de Molgas;1519;761;758
32;Ourense;008;Barbadás;11037;5367;5670
32;Ourense;009;Barco de Valdeorras, O;13395;6512;6883
32;Ourense;010;Beade;397;207;190
32;Ourense;011;Beariz;971;431;540
32;Ourense;012;Blancos, Os;766;411;355
32;Ourense;013;Boborás;2285;1091;1194
32;Ourense;014;Bola, A;1156;545;611
32;Ourense;015;Bolo, O;884;448;436
32;Ourense;016;Calvos de Randín;770;383;387
32;Ourense;018;Carballeda de Avia;1286;627;659
32;Ourense;017;Carballeda de Valdeorras;1545;793;752
32;Ourense;019;Carballiño, O;14027;6505;7522
32;Ourense;020;Cartelle;2642;1298;1344
32;Ourense;022;Castrelo de Miño;1349;683;666
32;Ourense;021;Castrelo do Val;984;499;485
32;Ourense;023;Castro Caldelas;1224;625;599
32;Ourense;024;Celanova;5649;2676;2973
32;Ourense;025;Cenlle;1120;561;559
32;Ourense;029;Chandrexa de Queixa;456;259;197
32;Ourense;026;Coles;3050;1536;1514
32;Ourense;027;Cortegada;1085;539;546
32;Ourense;028;Cualedro;1679;866;813
32;Ourense;030;Entrimo;1140;538;602
32;Ourense;031;Esgos;1116;577;539
32;Ourense;033;Gomesende;732;356;376
32;Ourense;034;Gudiña, A;1254;638;616
32;Ourense;035;Irixo, O;1466;716;750
32;Ourense;038;Larouco;429;207;222
32;Ourense;039;Laza;1228;641;587
32;Ourense;040;Leiro;1568;763;805
32;Ourense;041;Lobeira;798;390;408
32;Ourense;042;Lobios;1708;863;845
32;Ourense;043;Maceda;2872;1408;1464
32;Ourense;044;Manzaneda;870;422;448
32;Ourense;045;Maside;2705;1337;1368
32;Ourense;046;Melón;1184;565;619
32;Ourense;047;Merca, A;1913;943;970
32;Ourense;048;Mezquita, A;1023;530;493
32;Ourense;049;Montederramo;711;368;343
32;Ourense;050;Monterrei;2529;1293;1236
32;Ourense;051;Muíños;1502;761;741
32;Ourense;052;Nogueira de Ramuín;1998;1020;978
32;Ourense;053;Oímbra;1712;934;778
32;Ourense;054;Ourense;105233;47695;57538
32;Ourense;055;Paderne de Allariz;1384;693;691
32;Ourense;056;Padrenda;1748;860;888
32;Ourense;057;Parada de Sil;538;287;251
32;Ourense;058;Pereiro de Aguiar, O;6275;3211;3064
32;Ourense;059;Peroxa, A;1819;897;922
32;Ourense;060;Petín;861;420;441
32;Ourense;061;Piñor;1176;595;581
32;Ourense;063;Pobra de Trives, A;2067;1030;1037
32;Ourense;064;Pontedeva;511;252;259
32;Ourense;062;Porqueira;815;397;418
32;Ourense;065;Punxín;693;342;351
32;Ourense;066;Quintela de Leirado;619;274;345
32;Ourense;067;Rairiz de Veiga;1266;648;618
32;Ourense;068;Ramirás;1584;734;850
32;Ourense;069;Ribadavia;5024;2459;2565
32;Ourense;071;Riós;1516;774;742
32;Ourense;072;Rúa, A;4314;2125;2189
32;Ourense;073;Rubiá;1393;676;717
32;Ourense;074;San Amaro;1089;537;552
32;Ourense;075;San Cibrao das Viñas;5405;2752;2653
32;Ourense;076;San Cristovo de Cea;2137;1050;1087
32;Ourense;070;San Xoán de Río;531;270;261
32;Ourense;077;Sandiás;1206;558;648
32;Ourense;078;Sarreaus;1162;574;588
32;Ourense;079;Taboadela;1429;734;695
32;Ourense;080;Teixeira, A;316;159;157
32;Ourense;081;Toén;2355;1209;1146
32;Ourense;082;Trasmiras;1286;651;635
32;Ourense;083;Veiga, A;889;453;436
32;Ourense;084;Verea;943;453;490
32;Ourense;085;Verín;13723;6580;7143
32;Ourense;086;Viana do Bolo;2886;1458;1428
32;Ourense;087;Vilamarín;1854;952;902
32;Ourense;088;Vilamartín de Valdeorras;1790;914;876
32;Ourense;089;Vilar de Barrio;1307;661;646
32;Ourense;090;Vilar de Santos;820;401;419
32;Ourense;091;Vilardevós;1846;948;898
32;Ourense;092;Vilariño de Conso;519;303;216
32;Ourense;032;Xinzo de Limia;9715;4744;4971
32;Ourense;036;Xunqueira de Ambía;1375;689;686
32;Ourense;037;Xunqueira de Espadanedo;745;370;375
34;Palencia;001;Abarca de Campos;44;27;17
34;Palencia;003;Abia de las Torres;165;89;76
34;Palencia;004;Aguilar de Campoo;6744;3262;3482
34;Palencia;005;Alar del Rey;934;454;480
34;Palencia;006;Alba de Cerrato;87;47;40
34;Palencia;009;Amayuelas de Arriba;35;22;13
34;Palencia;010;Ampudia;605;310;295
34;Palencia;011;Amusco;423;237;186
34;Palencia;012;Antigüedad;363;191;172
34;Palencia;015;Arconada;41;25;16
34;Palencia;017;Astudillo;995;502;493
34;Palencia;018;Autilla del Pino;222;119;103
34;Palencia;019;Autillo de Campos;128;69;59
34;Palencia;020;Ayuela;52;33;19
34;Palencia;022;Baltanás;1191;623;568
34;Palencia;024;Baquerín de Campos;30;18;12
34;Palencia;025;Bárcena de Campos;59;26;33
34;Palencia;027;Barruelo de Santullán;1186;589;597
34;Palencia;028;Báscones de Ojeda;143;75;68
34;Palencia;029;Becerril de Campos;727;373;354
34;Palencia;031;Belmonte de Campos;30;15;15
34;Palencia;032;Berzosilla;40;21;19
34;Palencia;033;Boada de Campos;17;13;4
34;Palencia;035;Boadilla de Rioseco;107;61;46
34;Palencia;034;Boadilla del Camino;121;66;55
34;Palencia;036;Brañosera;271;147;124
34;Palencia;037;Buenavista de Valdavia;245;139;106
34;Palencia;038;Bustillo de la Vega;293;159;134
34;Palencia;039;Bustillo del Páramo de Carrión;60;37;23
34;Palencia;041;Calahorra de Boedo;90;44;46
34;Palencia;042;Calzada de los Molinos;330;183;147
34;Palencia;045;Capillas;75;40;35
34;Palencia;046;Cardeñosa de Volpejera;50;26;24
34;Palencia;047;Carrión de los Condes;2069;985;1084
34;Palencia;048;Castil de Vela;64;29;35
34;Palencia;049;Castrejón de la Peña;345;188;157
34;Palencia;050;Castrillo de Don Juan;207;117;90
34;Palencia;051;Castrillo de Onielo;98;52;46
34;Palencia;052;Castrillo de Villavega;174;96;78
34;Palencia;053;Castromocho;225;116;109
34;Palencia;055;Cervatos de la Cueza;280;153;127
34;Palencia;056;Cervera de Pisuerga;2333;1161;1172
34;Palencia;057;Cevico de la Torre;491;246;245
34;Palencia;058;Cevico Navero;194;110;84
34;Palencia;059;Cisneros;435;213;222
34;Palencia;060;Cobos de Cerrato;143;80;63
34;Palencia;061;Collazos de Boedo;102;60;42
34;Palencia;062;Congosto de Valdavia;153;91;62
34;Palencia;063;Cordovilla la Real;109;63;46
34;Palencia;066;Cubillas de Cerrato;61;36;25
34;Palencia;067;Dehesa de Montejo;133;78;55
34;Palencia;068;Dehesa de Romanos;50;30;20
34;Palencia;069;Dueñas;2612;1329;1283
34;Palencia;070;Espinosa de Cerrato;144;77;67
34;Palencia;071;Espinosa de Villagonzalo;172;91;81
34;Palencia;072;Frechilla;147;71;76
34;Palencia;073;Fresno del Río;189;93;96
34;Palencia;074;Frómista;767;401;366
34;Palencia;076;Fuentes de Nava;637;322;315
34;Palencia;077;Fuentes de Valdepero;451;237;214
34;Palencia;079;Grijota;2319;1214;1105
34;Palencia;080;Guardo;5995;2980;3015
34;Palencia;081;Guaza de Campos;60;37;23
34;Palencia;082;Hérmedes de Cerrato;80;42;38
34;Palencia;083;Herrera de Pisuerga;1966;959;1007
34;Palencia;084;Herrera de Valdecañas;161;90;71
34;Palencia;086;Hontoria de Cerrato;105;54;51
34;Palencia;087;Hornillos de Cerrato;141;81;60
34;Palencia;088;Husillos;320;181;139
34;Palencia;089;Itero de la Vega;152;90;62
34;Palencia;091;Lagartos;132;75;57
34;Palencia;092;Lantadilla;283;151;132
34;Palencia;094;Ledigos;64;31;33
34;Palencia;903;Loma de Ucieza;195;113;82
34;Palencia;096;Lomas;51;32;19
34;Palencia;098;Magaz de Pisuerga;1005;530;475
34;Palencia;099;Manquillos;66;36;30
34;Palencia;100;Mantinos;141;79;62
34;Palencia;101;Marcilla de Campos;46;21;25
34;Palencia;102;Mazariegos;220;131;89
34;Palencia;103;Mazuecos de Valdeginate;98;61;37
34;Palencia;104;Melgar de Yuso;251;145;106
34;Palencia;106;Meneses de Campos;124;67;57
34;Palencia;107;Micieces de Ojeda;73;41;32
34;Palencia;108;Monzón de Campos;592;309;283
34;Palencia;109;Moratinos;65;37;28
34;Palencia;110;Mudá;86;47;39
34;Palencia;112;Nogal de las Huertas;41;21;20
34;Palencia;113;Olea de Boedo;40;15;25
34;Palencia;114;Olmos de Ojeda;197;120;77
34;Palencia;116;Osornillo;56;30;26
34;Palencia;901;Osorno la Mayor;1205;638;567
34;Palencia;120;Palencia;78412;36990;41422
34;Palencia;121;Palenzuela;206;116;90
34;Palencia;122;Páramo de Boedo;126;72;54
34;Palencia;123;Paredes de Nava;1885;969;916
34;Palencia;124;Payo de Ojeda;67;39;28
34;Palencia;125;Pedraza de Campos;82;41;41
34;Palencia;126;Pedrosa de la Vega;300;168;132
34;Palencia;127;Perales;87;49;38
34;Palencia;904;Pernía, La;320;189;131
34;Palencia;129;Pino del Río;174;106;68
34;Palencia;130;Piña de Campos;217;109;108
34;Palencia;131;Población de Arroyo;60;32;28
34;Palencia;132;Población de Campos;129;73;56
34;Palencia;133;Población de Cerrato;109;65;44
34;Palencia;134;Polentinos;38;21;17
34;Palencia;135;Pomar de Valdivia;470;260;210
34;Palencia;136;Poza de la Vega;174;101;73
34;Palencia;137;Pozo de Urama;24;16;8
34;Palencia;139;Prádanos de Ojeda;191;102;89
34;Palencia;140;Puebla de Valdavia, La;100;55;45
34;Palencia;141;Quintana del Puente;263;143;120
34;Palencia;143;Quintanilla de Onsoña;179;105;74
34;Palencia;146;Reinoso de Cerrato;53;35;18
34;Palencia;147;Renedo de la Vega;187;103;84
34;Palencia;149;Requena de Campos;18;8;10
34;Palencia;151;Respenda de la Peña;151;89;62
34;Palencia;152;Revenga de Campos;152;79;73
34;Palencia;154;Revilla de Collazos;77;43;34
34;Palencia;155;Ribas de Campos;143;72;71
34;Palencia;156;Riberos de la Cueza;54;34;20
34;Palencia;157;Saldaña;2961;1512;1449
34;Palencia;158;Salinas de Pisuerga;319;168;151
34;Palencia;159;San Cebrián de Campos;415;232;183
34;Palencia;160;San Cebrián de Mudá;156;88;68
34;Palencia;161;San Cristóbal de Boedo;22;14;8
34;Palencia;163;San Mamés de Campos;52;27;25
34;Palencia;165;San Román de la Cuba;61;36;25
34;Palencia;167;Santa Cecilia del Alcor;118;69;49
34;Palencia;168;Santa Cruz de Boedo;48;30;18
34;Palencia;169;Santervás de la Vega;442;253;189
34;Palencia;170;Santibáñez de Ecla;52;29;23
34;Palencia;171;Santibáñez de la Peña;1035;510;525
34;Palencia;174;Santoyo;189;101;88
34;Palencia;175;Serna, La;96;62;34
34;Palencia;177;Soto de Cerrato;185;106;79
34;Palencia;176;Sotobañado y Priorato;142;83;59
34;Palencia;178;Tabanera de Cerrato;135;72;63
34;Palencia;179;Tabanera de Valdavia;27;16;11
34;Palencia;180;Támara de Campos;67;34;33
34;Palencia;181;Tariego de Cerrato;481;255;226
34;Palencia;182;Torquemada;954;526;428
34;Palencia;184;Torremormojón;44;25;19
34;Palencia;185;Triollo;67;36;31
34;Palencia;186;Valbuena de Pisuerga;47;25;22
34;Palencia;189;Valdeolmillos;57;32;25
34;Palencia;190;Valderrábano;50;27;23
34;Palencia;192;Valde-Ucieza;91;55;36
34;Palencia;196;Valle de Cerrato;90;53;37
34;Palencia;902;Valle del Retortillo;164;98;66
34;Palencia;199;Velilla del Río Carrión;1268;653;615
34;Palencia;023;Venta de Baños;6360;3199;3161
34;Palencia;201;Vertavillo;179;97;82
34;Palencia;093;Vid de Ojeda, La;94;57;37
34;Palencia;202;Villabasta de Valdavia;32;18;14
34;Palencia;204;Villacidaler;53;30;23
34;Palencia;205;Villaconancio;61;35;26
34;Palencia;206;Villada;934;481;453
34;Palencia;208;Villaeles de Valdavia;49;29;20
34;Palencia;210;Villahán;106;56;50
34;Palencia;211;Villaherreros;201;104;97
34;Palencia;213;Villalaco;56;32;24
34;Palencia;214;Villalba de Guardo;187;101;86
34;Palencia;215;Villalcázar de Sirga;172;88;84
34;Palencia;216;Villalcón;61;36;25
34;Palencia;217;Villalobón;1690;853;837
34;Palencia;218;Villaluenga de la Vega;595;340;255
34;Palencia;220;Villamartín de Campos;176;100;76
34;Palencia;221;Villamediana;175;97;78
34;Palencia;222;Villameriel;112;62;50
34;Palencia;223;Villamoronta;237;139;98
34;Palencia;224;Villamuera de la Cueza;43;28;15
34;Palencia;225;Villamuriel de Cerrato;6469;3345;3124
34;Palencia;227;Villanueva del Rebollar;75;37;38
34;Palencia;228;Villanuño de Valdavia;88;51;37
34;Palencia;229;Villaprovedo;59;40;19
34;Palencia;230;Villarmentero de Campos;17;12;5
34;Palencia;231;Villarrabé;208;107;101
34;Palencia;232;Villarramiel;820;446;374
34;Palencia;233;Villasarracino;141;86;55
34;Palencia;234;Villasila de Valdavia;72;49;23
34;Palencia;236;Villaturde;159;85;74
34;Palencia;237;Villaumbrales;648;322;326
34;Palencia;238;Villaviudas;357;174;183
34;Palencia;240;Villerías de Campos;90;49;41
34;Palencia;241;Villodre;18;11;7
34;Palencia;242;Villodrigo;114;61;53
34;Palencia;243;Villoldo;362;190;172
34;Palencia;245;Villota del Páramo;333;186;147
34;Palencia;246;Villovieco;76;39;37
35;Palmas, Las;001;Agaete;5586;2792;2794
35;Palmas, Las;002;Agüimes;31619;15984;15635
35;Palmas, Las;020;Aldea de San Nicolás, La;7504;3846;3658
35;Palmas, Las;003;Antigua;12461;6601;5860
35;Palmas, Las;004;Arrecife;62988;31512;31476
35;Palmas, Las;005;Artenara;1069;589;480
35;Palmas, Las;006;Arucas;38138;19000;19138
35;Palmas, Las;007;Betancuria;758;396;362
35;Palmas, Las;008;Firgas;7455;3755;3700
35;Palmas, Las;009;Gáldar;24242;12099;12143
35;Palmas, Las;010;Haría;5123;2641;2482
35;Palmas, Las;011;Ingenio;31321;15769;15552
35;Palmas, Las;012;Mogán;20072;10371;9701
35;Palmas, Las;013;Moya;7696;3913;3783
35;Palmas, Las;014;Oliva, La;26580;13825;12755
35;Palmas, Las;015;Pájara;21093;10977;10116
35;Palmas, Las;016;Palmas de Gran Canaria, Las;379925;183417;196508
35;Palmas, Las;017;Puerto del Rosario;40753;20640;20113
35;Palmas, Las;018;San Bartolomé;18816;9418;9398
35;Palmas, Las;019;San Bartolomé de Tirajana;53443;27888;25555
35;Palmas, Las;021;Santa Brígida;18263;9080;9183
35;Palmas, Las;022;Santa Lucía de Tirajana;73328;36623;36705
35;Palmas, Las;023;Santa María de Guía de Gran Canaria;13850;6907;6943
35;Palmas, Las;024;Teguise;22342;11264;11078
35;Palmas, Las;025;Tejeda;1909;1031;878
35;Palmas, Las;026;Telde;102647;50446;52201
35;Palmas, Las;027;Teror;12519;6428;6091
35;Palmas, Las;028;Tías;20170;10354;9816
35;Palmas, Las;029;Tinajo;6279;3232;3047
35;Palmas, Las;030;Tuineje;15241;7811;7430
35;Palmas, Las;032;Valleseco;3749;1964;1785
35;Palmas, Las;031;Valsequillo de Gran Canaria;9340;4689;4651
35;Palmas, Las;033;Vega de San Mateo;7556;3905;3651
35;Palmas, Las;034;Yaiza;16571;8607;7964
36;Pontevedra;020;Agolada;2344;1175;1169
36;Pontevedra;001;Arbo;2580;1328;1252
36;Pontevedra;003;Baiona;12122;5974;6148
36;Pontevedra;002;Barro;3680;1824;1856
36;Pontevedra;004;Bueu;12009;5924;6085
36;Pontevedra;005;Caldas de Reis;9785;4706;5079
36;Pontevedra;006;Cambados;13744;6614;7130
36;Pontevedra;007;Campo Lameiro;1817;858;959
36;Pontevedra;008;Cangas;26542;13135;13407
36;Pontevedra;009;Cañiza, A;5180;2535;2645
36;Pontevedra;010;Catoira;3335;1615;1720
36;Pontevedra;902;Cerdedo-Cotobade;5699;2759;2940
36;Pontevedra;013;Covelo;2396;1214;1182
36;Pontevedra;014;Crecente;2012;974;1038
36;Pontevedra;015;Cuntis;4677;2218;2459
36;Pontevedra;016;Dozón;1082;566;516
36;Pontevedra;017;Estrada, A;20479;9811;10668
36;Pontevedra;018;Forcarei;3388;1617;1771
36;Pontevedra;019;Fornelos de Montes;1616;770;846
36;Pontevedra;021;Gondomar;14286;7091;7195
36;Pontevedra;022;Grove, O;10650;5252;5398
36;Pontevedra;023;Guarda, A;9977;4877;5100
36;Pontevedra;901;Illa de Arousa, A;4926;2458;2468
36;Pontevedra;024;Lalín;20218;9846;10372
36;Pontevedra;025;Lama, A;2445;1199;1246
36;Pontevedra;026;Marín;24319;12153;12166
36;Pontevedra;027;Meaño;5272;2570;2702
36;Pontevedra;028;Meis;4791;2290;2501
36;Pontevedra;029;Moaña;19399;9431;9968
36;Pontevedra;030;Mondariz;4440;2199;2241
36;Pontevedra;031;Mondariz-Balneario;644;327;317
36;Pontevedra;032;Moraña;4179;2024;2155
36;Pontevedra;033;Mos;15078;7453;7625
36;Pontevedra;034;Neves, As;3841;1862;1979
36;Pontevedra;035;Nigrán;17675;8680;8995
36;Pontevedra;036;Oia;3053;1521;1532
36;Pontevedra;037;Pazos de Borbén;2999;1471;1528
36;Pontevedra;041;Poio;17082;8487;8595
36;Pontevedra;043;Ponte Caldelas;5494;2670;2824
36;Pontevedra;042;Ponteareas;22877;11068;11809
36;Pontevedra;044;Pontecesures;3052;1512;1540
36;Pontevedra;038;Pontevedra;83029;39300;43729
36;Pontevedra;039;Porriño, O;19848;9806;10042
36;Pontevedra;040;Portas;2940;1417;1523
36;Pontevedra;045;Redondela;29218;14208;15010
36;Pontevedra;046;Ribadumia;5052;2459;2593
36;Pontevedra;047;Rodeiro;2437;1236;1201
36;Pontevedra;048;Rosal, O;6234;3062;3172
36;Pontevedra;049;Salceda de Caselas;9164;4566;4598
36;Pontevedra;050;Salvaterra de Miño;9819;4905;4914
36;Pontevedra;051;Sanxenxo;17347;8565;8782
36;Pontevedra;052;Silleda;8687;4212;4475
36;Pontevedra;053;Soutomaior;7395;3677;3718
36;Pontevedra;054;Tomiño;13499;6815;6684
36;Pontevedra;055;Tui;16701;8046;8655
36;Pontevedra;056;Valga;5869;2890;2979
36;Pontevedra;057;Vigo;295364;139699;155665
36;Pontevedra;059;Vila de Cruces;5246;2578;2668
36;Pontevedra;058;Vilaboa;5874;2859;3015
36;Pontevedra;060;Vilagarcía de Arousa;37456;17930;19526
36;Pontevedra;061;Vilanova de Arousa;10302;4998;5304
26;Rioja, La;001;Ábalos;257;149;108
26;Rioja, La;002;Agoncillo;1102;606;496
26;Rioja, La;003;Aguilar del Río Alhama;460;234;226
26;Rioja, La;004;Ajamil de Cameros;66;45;21
26;Rioja, La;005;Albelda de Iregua;3446;1763;1683
26;Rioja, La;006;Alberite;2422;1225;1197
26;Rioja, La;007;Alcanadre;643;338;305
26;Rioja, La;008;Aldeanueva de Ebro;2761;1438;1323
26;Rioja, La;009;Alesanco;505;267;238
26;Rioja, La;010;Alesón;99;60;39
26;Rioja, La;011;Alfaro;9476;4751;4725
26;Rioja, La;012;Almarza de Cameros;36;21;15
26;Rioja, La;013;Anguciana;433;236;197
26;Rioja, La;014;Anguiano;497;282;215
26;Rioja, La;015;Arenzana de Abajo;230;118;112
26;Rioja, La;016;Arenzana de Arriba;29;20;9
26;Rioja, La;017;Arnedillo;419;201;218
26;Rioja, La;018;Arnedo;14875;7415;7460
26;Rioja, La;019;Arrúbal;506;271;235
26;Rioja, La;020;Ausejo;780;414;366
26;Rioja, La;021;Autol;4512;2231;2281
26;Rioja, La;022;Azofra;215;117;98
26;Rioja, La;023;Badarán;482;249;233
26;Rioja, La;024;Bañares;241;128;113
26;Rioja, La;026;Baños de Río Tobía;1579;783;796
26;Rioja, La;025;Baños de Rioja;91;53;38
26;Rioja, La;027;Berceo;157;96;61
26;Rioja, La;028;Bergasa;148;82;66
26;Rioja, La;029;Bergasillas Bajera;37;19;18
26;Rioja, La;030;Bezares;22;10;12
26;Rioja, La;031;Bobadilla;100;51;49
26;Rioja, La;032;Brieva de Cameros;44;29;15
26;Rioja, La;033;Briñas;193;90;103
26;Rioja, La;034;Briones;745;392;353
26;Rioja, La;035;Cabezón de Cameros;18;12;6
26;Rioja, La;036;Calahorra;24220;11900;12320
26;Rioja, La;037;Camprovín;151;82;69
26;Rioja, La;038;Canales de la Sierra;91;57;34
26;Rioja, La;039;Canillas de Río Tuerto;40;22;18
26;Rioja, La;040;Cañas;102;53;49
26;Rioja, La;041;Cárdenas;136;72;64
26;Rioja, La;042;Casalarreina;1098;556;542
26;Rioja, La;043;Castañares de Rioja;415;199;216
26;Rioja, La;044;Castroviejo;54;33;21
26;Rioja, La;045;Cellorigo;11;4;7
26;Rioja, La;046;Cenicero;2076;1061;1015
26;Rioja, La;047;Cervera del Río Alhama;2294;1182;1112
26;Rioja, La;048;Cidamón;25;13;12
26;Rioja, La;049;Cihuri;178;93;85
26;Rioja, La;050;Cirueña;153;98;55
26;Rioja, La;051;Clavijo;260;156;104
26;Rioja, La;052;Cordovín;156;76;80
26;Rioja, La;053;Corera;257;132;125
26;Rioja, La;054;Cornago;312;181;131
26;Rioja, La;055;Corporales;41;25;16
26;Rioja, La;056;Cuzcurrita de Río Tirón;493;271;222
26;Rioja, La;057;Daroca de Rioja;52;34;18
26;Rioja, La;058;Enciso;160;100;60
26;Rioja, La;059;Entrena;1536;801;735
26;Rioja, La;060;Estollo;85;56;29
26;Rioja, La;061;Ezcaray;2024;1051;973
26;Rioja, La;062;Foncea;93;54;39
26;Rioja, La;063;Fonzaleche;135;85;50
26;Rioja, La;064;Fuenmayor;3134;1585;1549
26;Rioja, La;065;Galbárruli;62;42;20
26;Rioja, La;066;Galilea;351;177;174
26;Rioja, La;067;Gallinero de Cameros;22;15;7
26;Rioja, La;068;Gimileo;112;61;51
26;Rioja, La;069;Grañón;254;144;110
26;Rioja, La;070;Grávalos;185;100;85
26;Rioja, La;071;Haro;11408;5611;5797
26;Rioja, La;072;Herce;336;175;161
26;Rioja, La;073;Herramélluri;114;62;52
26;Rioja, La;074;Hervías;121;62;59
26;Rioja, La;075;Hormilla;416;226;190
26;Rioja, La;076;Hormilleja;133;65;68
26;Rioja, La;077;Hornillos de Cameros;17;9;8
26;Rioja, La;078;Hornos de Moncalvillo;98;58;40
26;Rioja, La;079;Huércanos;817;451;366
26;Rioja, La;080;Igea;595;341;254
26;Rioja, La;081;Jalón de Cameros;21;10;11
26;Rioja, La;082;Laguna de Cameros;104;64;40
26;Rioja, La;083;Lagunilla del Jubera;375;209;166
26;Rioja, La;084;Lardero;10500;5262;5238
26;Rioja, La;086;Ledesma de la Cogolla;15;12;3
26;Rioja, La;087;Leiva;221;109;112
26;Rioja, La;088;Leza de Río Leza;42;25;17
26;Rioja, La;089;Logroño;151136;71718;79418
26;Rioja, La;091;Lumbreras;154;105;49
26;Rioja, La;092;Manjarrés;121;72;49
26;Rioja, La;093;Mansilla de la Sierra;56;41;15
26;Rioja, La;094;Manzanares de Rioja;69;40;29
26;Rioja, La;095;Matute;98;56;42
26;Rioja, La;096;Medrano;338;181;157
26;Rioja, La;098;Munilla;115;64;51
26;Rioja, La;099;Murillo de Río Leza;1629;838;791
26;Rioja, La;100;Muro de Aguas;62;36;26
26;Rioja, La;101;Muro en Cameros;36;20;16
26;Rioja, La;102;Nájera;8045;3949;4096
26;Rioja, La;103;Nalda;1023;555;468
26;Rioja, La;104;Navajún;10;8;2
26;Rioja, La;105;Navarrete;2941;1490;1451
26;Rioja, La;106;Nestares;84;46;38
26;Rioja, La;107;Nieva de Cameros;90;62;28
26;Rioja, La;109;Ochánduri;78;47;31
26;Rioja, La;108;Ocón;301;184;117
26;Rioja, La;110;Ojacastro;182;109;73
26;Rioja, La;111;Ollauri;291;154;137
26;Rioja, La;112;Ortigosa de Cameros;229;138;91
26;Rioja, La;113;Pazuengos;30;23;7
26;Rioja, La;114;Pedroso;74;51;23
26;Rioja, La;115;Pinillos;23;13;10
26;Rioja, La;117;Pradejón;3871;1985;1886
26;Rioja, La;118;Pradillo;75;40;35
26;Rioja, La;119;Préjano;214;115;99
26;Rioja, La;120;Quel;2058;1081;977
26;Rioja, La;121;Rabanera;32;21;11
26;Rioja, La;122;Rasillo de Cameros, El;144;78;66
26;Rioja, La;123;Redal, El;143;77;66
26;Rioja, La;124;Ribafrecha;967;501;466
26;Rioja, La;125;Rincón de Soto;3783;1927;1856
26;Rioja, La;126;Robres del Castillo;29;19;10
26;Rioja, La;127;Rodezno;229;125;104
26;Rioja, La;128;Sajazarra;124;63;61
26;Rioja, La;129;San Asensio;1114;589;525
26;Rioja, La;130;San Millán de la Cogolla;230;151;79
26;Rioja, La;131;San Millán de Yécora;34;24;10
26;Rioja, La;132;San Román de Cameros;128;78;50
26;Rioja, La;139;San Torcuato;61;31;30
26;Rioja, La;142;San Vicente de la Sonsierra;990;520;470
26;Rioja, La;134;Santa Coloma;94;58;36
26;Rioja, La;135;Santa Engracia del Jubera;161;106;55
26;Rioja, La;136;Santa Eulalia Bajera;112;61;51
26;Rioja, La;138;Santo Domingo de la Calzada;6238;3095;3143
26;Rioja, La;140;Santurde de Rioja;286;151;135
26;Rioja, La;141;Santurdejo;106;68;38
26;Rioja, La;143;Sojuela;313;179;134
26;Rioja, La;144;Sorzano;222;125;97
26;Rioja, La;145;Sotés;294;165;129
26;Rioja, La;146;Soto en Cameros;89;52;37
26;Rioja, La;147;Terroba;34;20;14
26;Rioja, La;148;Tirgo;180;89;91
26;Rioja, La;149;Tobía;50;30;20
26;Rioja, La;150;Tormantos;131;79;52
26;Rioja, La;153;Torre en Cameros;10;8;2
26;Rioja, La;151;Torrecilla en Cameros;456;252;204
26;Rioja, La;152;Torrecilla sobre Alesanco;32;19;13
26;Rioja, La;154;Torremontalbo;10;7;3
26;Rioja, La;155;Treviana;154;81;73
26;Rioja, La;157;Tricio;380;182;198
26;Rioja, La;158;Tudelilla;361;198;163
26;Rioja, La;160;Uruñuela;976;489;487
26;Rioja, La;161;Valdemadera;8;5;3
26;Rioja, La;162;Valgañón;126;77;49
26;Rioja, La;163;Ventosa;159;83;76
26;Rioja, La;164;Ventrosa;56;32;24
26;Rioja, La;165;Viguera;387;222;165
26;Rioja, La;166;Villalba de Rioja;160;100;60
26;Rioja, La;167;Villalobar de Rioja;58;42;16
26;Rioja, La;168;Villamediana de Iregua;8070;4078;3992
26;Rioja, La;169;Villanueva de Cameros;74;41;33
26;Rioja, La;170;Villar de Arnedo, El;593;306;287
26;Rioja, La;171;Villar de Torre;158;97;61
26;Rioja, La;172;Villarejo;27;20;7
26;Rioja, La;173;Villarroya;5;3;2
26;Rioja, La;174;Villarta-Quintana;140;83;57
26;Rioja, La;175;Villavelayo;50;33;17
26;Rioja, La;176;Villaverde de Rioja;56;32;24
26;Rioja, La;177;Villoslada de Cameros;324;200;124
26;Rioja, La;178;Viniegra de Abajo;77;48;29
26;Rioja, La;179;Viniegra de Arriba;42;28;14
26;Rioja, La;180;Zarratón;264;139;125
26;Rioja, La;181;Zarzosa;14;10;4
26;Rioja, La;183;Zorraquín;93;43;50
37;Salamanca;001;Abusejo;183;98;85
37;Salamanca;002;Agallas;136;70;66
37;Salamanca;003;Ahigal de los Aceiteros;114;64;50
37;Salamanca;004;Ahigal de Villarino;31;17;14
37;Salamanca;005;Alameda de Gardón, La;70;36;34
37;Salamanca;006;Alamedilla, La;126;63;63
37;Salamanca;007;Alaraz;439;230;209
37;Salamanca;008;Alba de Tormes;5186;2603;2583
37;Salamanca;009;Alba de Yeltes;207;111;96
37;Salamanca;010;Alberca, La;1081;527;554
37;Salamanca;011;Alberguería de Argañán, La;112;57;55
37;Salamanca;012;Alconada;149;79;70
37;Salamanca;015;Aldea del Obispo;243;126;117
37;Salamanca;013;Aldeacipreste;109;57;52
37;Salamanca;014;Aldeadávila de la Ribera;1224;616;608
37;Salamanca;016;Aldealengua;664;328;336
37;Salamanca;017;Aldeanueva de Figueroa;254;134;120
37;Salamanca;018;Aldeanueva de la Sierra;115;66;49
37;Salamanca;019;Aldearrodrigo;143;78;65
37;Salamanca;020;Aldearrubia;480;259;221
37;Salamanca;021;Aldeaseca de Alba;70;34;36
37;Salamanca;022;Aldeaseca de la Frontera;261;137;124
37;Salamanca;023;Aldeatejada;2064;1043;1021
37;Salamanca;024;Aldeavieja de Tormes;104;56;48
37;Salamanca;025;Aldehuela de la Bóveda;275;147;128
37;Salamanca;026;Aldehuela de Yeltes;190;103;87
37;Salamanca;027;Almenara de Tormes;262;146;116
37;Salamanca;028;Almendra;146;85;61
37;Salamanca;029;Anaya de Alba;201;118;83
37;Salamanca;030;Añover de Tormes;86;46;40
37;Salamanca;031;Arabayona de Mógica;357;202;155
37;Salamanca;032;Arapiles;660;355;305
37;Salamanca;033;Arcediano;107;58;49
37;Salamanca;034;Arco, El;86;42;44
37;Salamanca;035;Armenteros;198;111;87
37;Salamanca;037;Atalaya, La;114;63;51
37;Salamanca;038;Babilafuente;885;467;418
37;Salamanca;039;Bañobárez;305;156;149
37;Salamanca;040;Barbadillo;402;215;187
37;Salamanca;041;Barbalos;73;41;32
37;Salamanca;042;Barceo;46;29;17
37;Salamanca;044;Barruecopardo;450;250;200
37;Salamanca;045;Bastida, La;28;16;12
37;Salamanca;046;Béjar;12739;6026;6713
37;Salamanca;047;Beleña;256;129;127
37;Salamanca;049;Bermellar;134;68;66
37;Salamanca;050;Berrocal de Huebra;70;39;31
37;Salamanca;051;Berrocal de Salvatierra;84;45;39
37;Salamanca;052;Boada;302;152;150
37;Salamanca;054;Bodón, El;270;147;123
37;Salamanca;055;Bogajo;134;74;60
37;Salamanca;056;Bouza, La;55;24;31
37;Salamanca;057;Bóveda del Río Almar;229;125;104
37;Salamanca;058;Brincones;58;29;29
37;Salamanca;059;Buenamadre;127;66;61
37;Salamanca;060;Buenavista;360;198;162
37;Salamanca;061;Cabaco, El;221;114;107
37;Salamanca;063;Cabeza de Béjar, La;62;38;24
37;Salamanca;065;Cabeza del Caballo;279;149;130
37;Salamanca;062;Cabezabellosa de la Calzada;77;46;31
37;Salamanca;067;Cabrerizos;4263;2121;2142
37;Salamanca;068;Cabrillas;370;188;182
37;Salamanca;069;Calvarrasa de Abajo;1163;617;546
37;Salamanca;070;Calvarrasa de Arriba;586;315;271
37;Salamanca;071;Calzada de Béjar, La;86;46;40
37;Salamanca;072;Calzada de Don Diego;152;82;70
37;Salamanca;073;Calzada de Valdunciel;703;349;354
37;Salamanca;074;Campillo de Azaba;159;94;65
37;Salamanca;077;Campo de Peñaranda, El;261;153;108
37;Salamanca;078;Candelario;879;447;432
37;Salamanca;079;Canillas de Abajo;86;59;27
37;Salamanca;080;Cantagallo;255;135;120
37;Salamanca;081;Cantalapiedra;953;499;454
37;Salamanca;082;Cantalpino;851;463;388
37;Salamanca;083;Cantaracillo;190;104;86
37;Salamanca;085;Carbajosa de la Sagrada;7116;3541;3575
37;Salamanca;086;Carpio de Azaba;112;63;49
37;Salamanca;087;Carrascal de Barregas;1206;630;576
37;Salamanca;088;Carrascal del Obispo;209;113;96
37;Salamanca;089;Casafranca;65;35;30
37;Salamanca;090;Casas del Conde, Las;69;32;37
37;Salamanca;091;Casillas de Flores;178;89;89
37;Salamanca;092;Castellanos de Moriscos;2677;1384;1293
37;Salamanca;185;Castellanos de Villiquera;617;337;280
37;Salamanca;096;Castillejo de Martín Viejo;222;134;88
37;Salamanca;097;Castraz;44;29;15
37;Salamanca;098;Cepeda;311;155;156
37;Salamanca;099;Cereceda de la Sierra;64;33;31
37;Salamanca;100;Cerezal de Peñahorcada;78;40;38
37;Salamanca;101;Cerralbo;146;81;65
37;Salamanca;102;Cerro, El;407;205;202
37;Salamanca;103;Cespedosa de Tormes;495;267;228
37;Salamanca;114;Chagarcía Medianero;82;45;37
37;Salamanca;104;Cilleros de la Bastida;26;12;14
37;Salamanca;106;Cipérez;271;142;129
37;Salamanca;107;Ciudad Rodrigo;12344;5932;6412
37;Salamanca;108;Coca de Alba;109;52;57
37;Salamanca;109;Colmenar de Montemayor;182;105;77
37;Salamanca;110;Cordovilla;118;61;57
37;Salamanca;112;Cristóbal;157;90;67
37;Salamanca;113;Cubo de Don Sancho, El;440;233;207
37;Salamanca;115;Dios le Guarde;121;68;53
37;Salamanca;116;Doñinos de Ledesma;71;37;34
37;Salamanca;117;Doñinos de Salamanca;2097;1105;992
37;Salamanca;118;Éjeme;126;72;54
37;Salamanca;120;Encina de San Silvestre;112;55;57
37;Salamanca;119;Encina, La;99;59;40
37;Salamanca;121;Encinas de Abajo;633;339;294
37;Salamanca;122;Encinas de Arriba;237;120;117
37;Salamanca;123;Encinasola de los Comendadores;164;92;72
37;Salamanca;124;Endrinal;218;118;100
37;Salamanca;125;Escurial de la Sierra;239;135;104
37;Salamanca;126;Espadaña;31;19;12
37;Salamanca;127;Espeja;222;114;108
37;Salamanca;128;Espino de la Orbada;262;145;117
37;Salamanca;129;Florida de Liébana;270;144;126
37;Salamanca;130;Forfoleda;193;108;85
37;Salamanca;131;Frades de la Sierra;183;104;79
37;Salamanca;132;Fregeneda, La;348;171;177
37;Salamanca;133;Fresnedoso;106;61;45
37;Salamanca;134;Fresno Alhándiga;213;116;97
37;Salamanca;135;Fuente de San Esteban, La;1299;657;642
37;Salamanca;136;Fuenteguinaldo;677;333;344
37;Salamanca;137;Fuenteliante;101;51;50
37;Salamanca;138;Fuenterroble de Salvatierra;268;139;129
37;Salamanca;139;Fuentes de Béjar;216;106;110
37;Salamanca;140;Fuentes de Oñoro;1134;601;533
37;Salamanca;141;Gajates;163;75;88
37;Salamanca;142;Galindo y Perahuy;684;397;287
37;Salamanca;143;Galinduste;427;209;218
37;Salamanca;144;Galisancho;378;203;175
37;Salamanca;145;Gallegos de Argañán;283;139;144
37;Salamanca;146;Gallegos de Solmirón;110;63;47
37;Salamanca;147;Garcibuey;183;108;75
37;Salamanca;148;Garcihernández;449;236;213
37;Salamanca;149;Garcirrey;61;36;25
37;Salamanca;150;Gejuelo del Barro;38;22;16
37;Salamanca;151;Golpejas;151;74;77
37;Salamanca;152;Gomecello;442;235;207
37;Salamanca;154;Guadramiro;140;84;56
37;Salamanca;155;Guijo de Ávila;76;42;34
37;Salamanca;156;Guijuelo;5633;2821;2812
37;Salamanca;157;Herguijuela de Ciudad Rodrigo;78;46;32
37;Salamanca;158;Herguijuela de la Sierra;250;139;111
37;Salamanca;159;Herguijuela del Campo;80;41;39
37;Salamanca;160;Hinojosa de Duero;659;330;329
37;Salamanca;161;Horcajo de Montemayor;138;75;63
37;Salamanca;162;Horcajo Medianero;225;115;110
37;Salamanca;163;Hoya, La;36;20;16
37;Salamanca;164;Huerta;284;161;123
37;Salamanca;165;Iruelos;33;15;18
37;Salamanca;166;Ituero de Azaba;214;112;102
37;Salamanca;167;Juzbado;194;99;95
37;Salamanca;168;Lagunilla;466;252;214
37;Salamanca;169;Larrodrigo;187;108;79
37;Salamanca;170;Ledesma;1599;799;800
37;Salamanca;171;Ledrada;481;241;240
37;Salamanca;172;Linares de Riofrío;949;517;432
37;Salamanca;173;Lumbrales;1590;801;789
37;Salamanca;175;Machacón;454;238;216
37;Salamanca;174;Macotera;1037;529;508
37;Salamanca;176;Madroñal;142;77;65
37;Salamanca;177;Maíllo, El;260;146;114
37;Salamanca;178;Malpartida;98;52;46
37;Salamanca;179;Mancera de Abajo;202;107;95
37;Salamanca;180;Manzano, El;68;36;32
37;Salamanca;181;Martiago;263;140;123
37;Salamanca;183;Martín de Yeltes;415;215;200
37;Salamanca;182;Martinamor;85;53;32
37;Salamanca;184;Masueco;272;139;133
37;Salamanca;186;Mata de Ledesma, La;98;55;43
37;Salamanca;187;Matilla de los Caños del Río;635;320;315
37;Salamanca;188;Maya, La;162;99;63
37;Salamanca;189;Membribe de la Sierra;119;72;47
37;Salamanca;190;Mieza;196;102;94
37;Salamanca;191;Milano, El;106;62;44
37;Salamanca;192;Miranda de Azán;433;227;206
37;Salamanca;193;Miranda del Castañar;402;215;187
37;Salamanca;194;Mogarraz;277;141;136
37;Salamanca;195;Molinillo;39;23;16
37;Salamanca;196;Monforte de la Sierra;70;38;32
37;Salamanca;197;Monleón;93;53;40
37;Salamanca;198;Monleras;226;108;118
37;Salamanca;199;Monsagro;137;74;63
37;Salamanca;200;Montejo;216;124;92
37;Salamanca;201;Montemayor del Río;263;141;122
37;Salamanca;202;Monterrubio de Armuña;1343;703;640
37;Salamanca;203;Monterrubio de la Sierra;156;86;70
37;Salamanca;204;Morasverdes;254;134;120
37;Salamanca;205;Morille;233;128;105
37;Salamanca;206;Moríñigo;95;53;42
37;Salamanca;207;Moriscos;429;234;195
37;Salamanca;208;Moronta;71;45;26
37;Salamanca;209;Mozárbez;499;261;238
37;Salamanca;211;Narros de Matalayegua;223;124;99
37;Salamanca;213;Nava de Béjar;94;54;40
37;Salamanca;214;Nava de Francia;126;68;58
37;Salamanca;215;Nava de Sotrobal;155;88;67
37;Salamanca;212;Navacarros;112;57;55
37;Salamanca;216;Navales;325;176;149
37;Salamanca;217;Navalmoral de Béjar;59;27;32
37;Salamanca;218;Navamorales;51;32;19
37;Salamanca;219;Navarredonda de la Rinconada;169;85;84
37;Salamanca;221;Navasfrías;436;230;206
37;Salamanca;222;Negrilla de Palencia;88;53;35
37;Salamanca;223;Olmedo de Camaces;112;59;53
37;Salamanca;224;Orbada, La;199;104;95
37;Salamanca;225;Pajares de la Laguna;110;59;51
37;Salamanca;226;Palacios del Arzobispo;165;80;85
37;Salamanca;228;Palaciosrubios;335;174;161
37;Salamanca;229;Palencia de Negrilla;154;91;63
37;Salamanca;230;Parada de Arriba;251;129;122
37;Salamanca;231;Parada de Rubiales;252;132;120
37;Salamanca;232;Paradinas de San Juan;396;232;164
37;Salamanca;233;Pastores;59;36;23
37;Salamanca;234;Payo, El;338;163;175
37;Salamanca;235;Pedraza de Alba;235;124;111
37;Salamanca;236;Pedrosillo de Alba;136;81;55
37;Salamanca;237;Pedrosillo de los Aires;350;198;152
37;Salamanca;238;Pedrosillo el Ralo;124;66;58
37;Salamanca;239;Pedroso de la Armuña, El;214;112;102
37;Salamanca;240;Pelabravo;1191;633;558
37;Salamanca;241;Pelarrodríguez;168;102;66
37;Salamanca;242;Pelayos;81;49;32
37;Salamanca;243;Peña, La;92;44;48
37;Salamanca;244;Peñacaballera;139;70;69
37;Salamanca;245;Peñaparda;353;176;177
37;Salamanca;246;Peñaranda de Bracamonte;6260;3076;3184
37;Salamanca;247;Peñarandilla;182;99;83
37;Salamanca;248;Peralejos de Abajo;164;86;78
37;Salamanca;249;Peralejos de Arriba;38;25;13
37;Salamanca;250;Pereña de la Ribera;345;187;158
37;Salamanca;251;Peromingo;118;55;63
37;Salamanca;252;Pinedas;107;60;47
37;Salamanca;253;Pino de Tormes, El;155;83;72
37;Salamanca;254;Pitiegua;184;102;82
37;Salamanca;255;Pizarral;46;30;16
37;Salamanca;256;Poveda de las Cintas;211;122;89
37;Salamanca;257;Pozos de Hinojo;51;28;23
37;Salamanca;258;Puebla de Azaba;162;88;74
37;Salamanca;259;Puebla de San Medel;39;22;17
37;Salamanca;260;Puebla de Yeltes;149;78;71
37;Salamanca;261;Puente del Congosto;230;129;101
37;Salamanca;262;Puertas;79;45;34
37;Salamanca;263;Puerto de Béjar;370;176;194
37;Salamanca;264;Puerto Seguro;57;27;30
37;Salamanca;265;Rágama;218;115;103
37;Salamanca;266;Redonda, La;75;43;32
37;Salamanca;267;Retortillo;194;106;88
37;Salamanca;268;Rinconada de la Sierra, La;112;63;49
37;Salamanca;269;Robleda;492;269;223
37;Salamanca;270;Robliza de Cojos;198;102;96
37;Salamanca;271;Rollán;371;203;168
37;Salamanca;272;Saelices el Chico;150;86;64
37;Salamanca;273;Sagrada, La;95;55;40
37;Salamanca;303;Sahugo, El;186;103;83
37;Salamanca;274;Salamanca;144228;65359;78869
37;Salamanca;275;Saldeana;105;62;43
37;Salamanca;276;Salmoral;127;78;49
37;Salamanca;277;Salvatierra de Tormes;79;38;41
37;Salamanca;278;San Cristóbal de la Cuesta;1039;552;487
37;Salamanca;284;San Esteban de la Sierra;343;194;149
37;Salamanca;285;San Felices de los Gallegos;395;206;189
37;Salamanca;286;San Martín del Castañar;223;121;102
37;Salamanca;287;San Miguel de Valero;334;173;161
37;Salamanca;036;San Miguel del Robledo;56;33;23
37;Salamanca;288;San Morales;334;182;152
37;Salamanca;289;San Muñoz;233;116;117
37;Salamanca;291;San Pedro de Rozados;291;164;127
37;Salamanca;290;San Pedro del Valle;138;76;62
37;Salamanca;292;San Pelayo de Guareña;89;51;38
37;Salamanca;280;Sanchón de la Ribera;80;42;38
37;Salamanca;281;Sanchón de la Sagrada;39;23;16
37;Salamanca;282;Sanchotello;217;115;102
37;Salamanca;279;Sancti-Spíritus;804;434;370
37;Salamanca;283;Sando;123;75;48
37;Salamanca;293;Santa María de Sando;110;58;52
37;Salamanca;294;Santa Marta de Tormes;14805;7271;7534
37;Salamanca;296;Santiago de la Puebla;310;161;149
37;Salamanca;297;Santibáñez de Béjar;461;233;228
37;Salamanca;298;Santibáñez de la Sierra;180;102;78
37;Salamanca;299;Santiz;249;134;115
37;Salamanca;300;Santos, Los;610;313;297
37;Salamanca;301;Sardón de los Frailes;88;49;39
37;Salamanca;302;Saucelle;276;140;136
37;Salamanca;304;Sepulcro-Hilario;176;100;76
37;Salamanca;305;Sequeros;237;117;120
37;Salamanca;306;Serradilla del Arroyo;261;144;117
37;Salamanca;307;Serradilla del Llano;155;79;76
37;Salamanca;309;Sierpe, La;40;20;20
37;Salamanca;310;Sieteiglesias de Tormes;187;89;98
37;Salamanca;311;Sobradillo;219;112;107
37;Salamanca;312;Sorihuela;261;138;123
37;Salamanca;313;Sotoserrano;573;308;265
37;Salamanca;314;Tabera de Abajo;106;60;46
37;Salamanca;315;Tala, La;84;48;36
37;Salamanca;316;Tamames;781;397;384
37;Salamanca;317;Tarazona de Guareña;305;166;139
37;Salamanca;318;Tardáguila;208;123;85
37;Salamanca;319;Tejado, El;96;52;44
37;Salamanca;320;Tejeda y Segoyuela;92;52;40
37;Salamanca;321;Tenebrón;140;72;68
37;Salamanca;322;Terradillos;3046;1522;1524
37;Salamanca;323;Topas;530;286;244
37;Salamanca;324;Tordillos;347;186;161
37;Salamanca;325;Tornadizo, El;93;52;41
37;Salamanca;327;Torresmenudas;190;97;93
37;Salamanca;328;Trabanca;184;90;94
37;Salamanca;329;Tremedal de Tormes;43;22;21
37;Salamanca;330;Valdecarros;338;171;167
37;Salamanca;331;Valdefuentes de Sangusín;196;110;86
37;Salamanca;332;Valdehijaderos;79;42;37
37;Salamanca;333;Valdelacasa;215;125;90
37;Salamanca;334;Valdelageve;76;39;37
37;Salamanca;335;Valdelosa;409;203;206
37;Salamanca;336;Valdemierque;63;40;23
37;Salamanca;337;Valderrodrigo;150;74;76
37;Salamanca;338;Valdunciel;98;49;49
37;Salamanca;339;Valero;330;180;150
37;Salamanca;343;Vallejera de Riofrío;73;33;40
37;Salamanca;340;Valsalabroso;145;82;63
37;Salamanca;341;Valverde de Valdelacasa;71;38;33
37;Salamanca;342;Valverdón;285;151;134
37;Salamanca;344;Vecinos;253;124;129
37;Salamanca;345;Vega de Tirados;163;91;72
37;Salamanca;346;Veguillas, Las;281;137;144
37;Salamanca;347;Vellés, La;537;297;240
37;Salamanca;348;Ventosa del Río Almar;106;60;46
37;Salamanca;349;Vídola, La;111;55;56
37;Salamanca;351;Villaflores;277;139;138
37;Salamanca;352;Villagonzalo de Tormes;216;128;88
37;Salamanca;353;Villalba de los Llanos;126;71;55
37;Salamanca;354;Villamayor;7202;3622;3580
37;Salamanca;355;Villanueva del Conde;173;85;88
37;Salamanca;356;Villar de Argañán;98;53;45
37;Salamanca;357;Villar de Ciervo;277;146;131
37;Salamanca;358;Villar de Gallimazo;192;118;74
37;Salamanca;359;Villar de la Yegua;174;91;83
37;Salamanca;360;Villar de Peralonso;231;119;112
37;Salamanca;361;Villar de Samaniego;88;49;39
37;Salamanca;362;Villares de la Reina;6351;3147;3204
37;Salamanca;363;Villares de Yeltes;113;52;61
37;Salamanca;364;Villarino de los Aires;796;416;380
37;Salamanca;365;Villarmayor;185;104;81
37;Salamanca;366;Villarmuerto;40;27;13
37;Salamanca;367;Villasbuenas;190;104;86
37;Salamanca;368;Villasdardo;21;6;15
37;Salamanca;369;Villaseco de los Gamitos;135;77;58
37;Salamanca;370;Villaseco de los Reyes;331;189;142
37;Salamanca;371;Villasrubias;271;149;122
37;Salamanca;372;Villaverde de Guareña;141;80;61
37;Salamanca;373;Villavieja de Yeltes;764;401;363
37;Salamanca;374;Villoria;1351;692;659
37;Salamanca;375;Villoruela;760;384;376
37;Salamanca;350;Vilvestre;429;210;219
37;Salamanca;376;Vitigudino;2499;1210;1289
37;Salamanca;377;Yecla de Yeltes;235;124;111
37;Salamanca;378;Zamarra;94;58;36
37;Salamanca;379;Zamayón;200;121;79
37;Salamanca;380;Zarapicos;58;34;24
37;Salamanca;381;Zarza de Pumareda, La;144;82;62
37;Salamanca;382;Zorita de la Frontera;164;83;81
38;Santa Cruz de Tenerife;001;Adeje;47869;24110;23759
38;Santa Cruz de Tenerife;002;Agulo;1096;547;549
38;Santa Cruz de Tenerife;003;Alajeró;2017;1061;956
38;Santa Cruz de Tenerife;004;Arafo;5551;2731;2820
38;Santa Cruz de Tenerife;005;Arico;7988;4151;3837
38;Santa Cruz de Tenerife;006;Arona;81216;41283;39933
38;Santa Cruz de Tenerife;007;Barlovento;1876;956;920
38;Santa Cruz de Tenerife;008;Breña Alta;7204;3540;3664
38;Santa Cruz de Tenerife;009;Breña Baja;5690;2857;2833
38;Santa Cruz de Tenerife;010;Buenavista del Norte;4778;2405;2373
38;Santa Cruz de Tenerife;011;Candelaria;27985;13619;14366
38;Santa Cruz de Tenerife;012;Fasnia;2786;1458;1328
38;Santa Cruz de Tenerife;013;Frontera;4093;2050;2043
38;Santa Cruz de Tenerife;014;Fuencaliente de la Palma;1722;857;865
38;Santa Cruz de Tenerife;015;Garachico;4871;2442;2429
38;Santa Cruz de Tenerife;016;Garafía;1667;881;786
38;Santa Cruz de Tenerife;017;Granadilla de Abona;50146;25076;25070
38;Santa Cruz de Tenerife;018;Guancha, La;5520;2687;2833
38;Santa Cruz de Tenerife;019;Guía de Isora;21368;10653;10715
38;Santa Cruz de Tenerife;020;Güímar;20190;10010;10180
38;Santa Cruz de Tenerife;021;Hermigua;1832;943;889
38;Santa Cruz de Tenerife;022;Icod de los Vinos;23254;11427;11827
38;Santa Cruz de Tenerife;024;Llanos de Aridane, Los;20467;9908;10559
38;Santa Cruz de Tenerife;025;Matanza de Acentejo, La;9061;4585;4476
38;Santa Cruz de Tenerife;026;Orotava, La;42029;20564;21465
38;Santa Cruz de Tenerife;027;Paso, El;7622;3795;3827
38;Santa Cruz de Tenerife;901;Pinar de El Hierro, El;1870;987;883
38;Santa Cruz de Tenerife;028;Puerto de la Cruz;30468;14889;15579
38;Santa Cruz de Tenerife;029;Puntagorda;2110;1070;1040
38;Santa Cruz de Tenerife;030;Puntallana;2506;1244;1262
38;Santa Cruz de Tenerife;031;Realejos, Los;36402;17862;18540
38;Santa Cruz de Tenerife;032;Rosario, El;17370;8792;8578
38;Santa Cruz de Tenerife;033;San Andrés y Sauces;4141;2074;2067
38;Santa Cruz de Tenerife;023;San Cristóbal de La Laguna;157503;76211;81292
38;Santa Cruz de Tenerife;034;San Juan de la Rambla;4828;2395;2433
38;Santa Cruz de Tenerife;035;San Miguel de Abona;20886;10563;10323
38;Santa Cruz de Tenerife;036;San Sebastián de la Gomera;9093;4560;4533
38;Santa Cruz de Tenerife;037;Santa Cruz de la Palma;15716;7595;8121
38;Santa Cruz de Tenerife;038;Santa Cruz de Tenerife;207312;98991;108321
38;Santa Cruz de Tenerife;039;Santa Úrsula;14679;7319;7360
38;Santa Cruz de Tenerife;040;Santiago del Teide;11111;5538;5573
38;Santa Cruz de Tenerife;041;Sauzal, El;8934;4409;4525
38;Santa Cruz de Tenerife;042;Silos, Los;4693;2348;2345
38;Santa Cruz de Tenerife;043;Tacoronte;24134;11990;12144
38;Santa Cruz de Tenerife;044;Tanque, El;2763;1338;1425
38;Santa Cruz de Tenerife;045;Tazacorte;4575;2342;2233
38;Santa Cruz de Tenerife;046;Tegueste;11294;5561;5733
38;Santa Cruz de Tenerife;047;Tijarafe;2532;1292;1240
38;Santa Cruz de Tenerife;049;Valle Gran Rey;4564;2301;2263
38;Santa Cruz de Tenerife;050;Vallehermoso;2901;1505;1396
38;Santa Cruz de Tenerife;048;Valverde;5005;2511;2494
38;Santa Cruz de Tenerife;051;Victoria de Acentejo, La;9185;4604;4581
38;Santa Cruz de Tenerife;052;Vilaflor de Chasna;1667;857;810
38;Santa Cruz de Tenerife;053;Villa de Mazo;4843;2453;2390
40;Segovia;001;Abades;848;417;431
40;Segovia;002;Adrada de Pirón;39;21;18
40;Segovia;003;Adrados;126;73;53
40;Segovia;004;Aguilafuente;573;286;287
40;Segovia;005;Alconada de Maderuelo;25;16;9
40;Segovia;012;Aldea Real;282;149;133
40;Segovia;006;Aldealcorvo;22;13;9
40;Segovia;007;Aldealengua de Pedraza;72;45;27
40;Segovia;008;Aldealengua de Santa María;63;31;32
40;Segovia;009;Aldeanueva de la Serrezuela;44;32;12
40;Segovia;010;Aldeanueva del Codonal;117;64;53
40;Segovia;013;Aldeasoña;56;33;23
40;Segovia;014;Aldehorno;53;32;21
40;Segovia;015;Aldehuela del Codonal;26;14;12
40;Segovia;016;Aldeonte;55;30;25
40;Segovia;017;Anaya;129;62;67
40;Segovia;018;Añe;77;45;32
40;Segovia;019;Arahuetes;30;22;8
40;Segovia;020;Arcones;166;80;86
40;Segovia;021;Arevalillo de Cega;20;12;8
40;Segovia;022;Armuña;219;121;98
40;Segovia;024;Ayllón;1196;617;579
40;Segovia;025;Barbolla;158;87;71
40;Segovia;026;Basardilla;153;68;85
40;Segovia;028;Bercial;111;60;51
40;Segovia;029;Bercimuel;24;13;11
40;Segovia;030;Bernardos;476;262;214
40;Segovia;031;Bernuy de Porreros;747;406;341
40;Segovia;032;Boceguillas;723;374;349
40;Segovia;033;Brieva;96;52;44
40;Segovia;034;Caballar;83;48;35
40;Segovia;035;Cabañas de Polendos;177;94;83
40;Segovia;036;Cabezuela;664;343;321
40;Segovia;037;Calabazas de Fuentidueña;28;15;13
40;Segovia;039;Campo de San Pedro;238;129;109
40;Segovia;040;Cantalejo;3523;1757;1766
40;Segovia;041;Cantimpalos;1325;694;631
40;Segovia;161;Carabias;57;38;19
40;Segovia;043;Carbonero el Mayor;2519;1305;1214
40;Segovia;044;Carrascal del Río;147;79;68
40;Segovia;045;Casla;165;85;80
40;Segovia;046;Castillejo de Mesleón;136;75;61
40;Segovia;047;Castro de Fuentidueña;31;20;11
40;Segovia;048;Castrojimeno;35;18;17
40;Segovia;049;Castroserna de Abajo;40;23;17
40;Segovia;051;Castroserracín;42;24;18
40;Segovia;052;Cedillo de la Torre;89;48;41
40;Segovia;053;Cerezo de Abajo;112;59;53
40;Segovia;054;Cerezo de Arriba;136;77;59
40;Segovia;065;Chañe;736;375;361
40;Segovia;055;Cilleruelo de San Mamés;33;20;13
40;Segovia;056;Cobos de Fuentidueña;34;16;18
40;Segovia;057;Coca;1763;891;872
40;Segovia;058;Codorniz;327;166;161
40;Segovia;059;Collado Hermoso;125;63;62
40;Segovia;060;Condado de Castilnovo;90;50;40
40;Segovia;061;Corral de Ayllón;77;45;32
40;Segovia;902;Cozuelos de Fuentidueña;131;72;59
40;Segovia;062;Cubillo;73;44;29
40;Segovia;063;Cuéllar;9583;4843;4740
40;Segovia;905;Cuevas de Provanco;136;77;59
40;Segovia;068;Domingo García;25;16;9
40;Segovia;069;Donhierro;91;47;44
40;Segovia;070;Duruelo;180;108;72
40;Segovia;071;Encinas;44;22;22
40;Segovia;072;Encinillas;304;168;136
40;Segovia;073;Escalona del Prado;499;260;239
40;Segovia;074;Escarabajosa de Cabezas;298;163;135
40;Segovia;075;Escobar de Polendos;167;88;79
40;Segovia;076;Espinar, El;8986;4557;4429
40;Segovia;077;Espirdo;1344;706;638
40;Segovia;078;Fresneda de Cuéllar;165;92;73
40;Segovia;079;Fresno de Cantespino;265;148;117
40;Segovia;080;Fresno de la Fuente;67;37;30
40;Segovia;081;Frumales;112;60;52
40;Segovia;082;Fuente de Santa Cruz;116;63;53
40;Segovia;083;Fuente el Olmo de Fuentidueña;176;78;98
40;Segovia;084;Fuente el Olmo de Íscar;56;31;25
40;Segovia;086;Fuentepelayo;836;442;394
40;Segovia;087;Fuentepiñel;96;53;43
40;Segovia;088;Fuenterrebollo;341;177;164
40;Segovia;089;Fuentesaúco de Fuentidueña;240;123;117
40;Segovia;091;Fuentesoto;108;59;49
40;Segovia;092;Fuentidueña;147;86;61
40;Segovia;093;Gallegos;104;57;47
40;Segovia;094;Garcillán;463;244;219
40;Segovia;095;Gomezserracín;683;359;324
40;Segovia;097;Grajera;238;137;101
40;Segovia;099;Honrubia de la Cuesta;58;34;24
40;Segovia;100;Hontalbilla;307;170;137
40;Segovia;101;Hontanares de Eresma;1464;762;702
40;Segovia;103;Huertos, Los;170;94;76
40;Segovia;104;Ituero y Lama;378;201;177
40;Segovia;105;Juarros de Riomoros;42;24;18
40;Segovia;106;Juarros de Voltoya;200;98;102
40;Segovia;107;Labajos;106;63;43
40;Segovia;108;Laguna de Contreras;114;66;48
40;Segovia;109;Languilla;84;51;33
40;Segovia;110;Lastras de Cuéllar;358;186;172
40;Segovia;111;Lastras del Pozo;64;34;30
40;Segovia;112;Lastrilla, La;3891;1976;1915
40;Segovia;113;Losa, La;521;291;230
40;Segovia;115;Maderuelo;168;99;69
40;Segovia;903;Marazoleja;101;65;36
40;Segovia;118;Marazuela;50;29;21
40;Segovia;119;Martín Miguel;212;128;84
40;Segovia;120;Martín Muñoz de la Dehesa;235;123;112
40;Segovia;121;Martín Muñoz de las Posadas;279;148;131
40;Segovia;122;Marugán;623;337;286
40;Segovia;124;Mata de Cuéllar;266;139;127
40;Segovia;123;Matabuena;157;87;70
40;Segovia;125;Matilla, La;84;50;34
40;Segovia;126;Melque de Cercos;68;36;32
40;Segovia;127;Membibre de la Hoz;36;19;17
40;Segovia;128;Migueláñez;131;71;60
40;Segovia;129;Montejo de Arévalo;177;97;80
40;Segovia;130;Montejo de la Vega de la Serrezuela;146;87;59
40;Segovia;131;Monterrubio;61;34;27
40;Segovia;132;Moral de Hornuez;49;29;20
40;Segovia;134;Mozoncillo;902;492;410
40;Segovia;135;Muñopedro;303;165;138
40;Segovia;136;Muñoveros;145;69;76
40;Segovia;138;Nava de la Asunción;2774;1400;1374
40;Segovia;139;Navafría;281;155;126
40;Segovia;140;Navalilla;103;56;47
40;Segovia;141;Navalmanzano;1049;546;503
40;Segovia;142;Navares de Ayuso;53;27;26
40;Segovia;143;Navares de Enmedio;94;57;37
40;Segovia;144;Navares de las Cuevas;23;15;8
40;Segovia;145;Navas de Oro;1338;677;661
40;Segovia;904;Navas de Riofrío;394;185;209
40;Segovia;146;Navas de San Antonio;328;170;158
40;Segovia;148;Nieva;264;132;132
40;Segovia;149;Olombrada;536;288;248
40;Segovia;150;Orejana;58;35;23
40;Segovia;151;Ortigosa de Pestaño;55;29;26
40;Segovia;901;Ortigosa del Monte;561;299;262
40;Segovia;152;Otero de Herreros;959;486;473
40;Segovia;154;Pajarejos;25;13;12
40;Segovia;155;Palazuelos de Eresma;5416;2801;2615
40;Segovia;156;Pedraza;344;196;148
40;Segovia;157;Pelayos del Arroyo;45;27;18
40;Segovia;158;Perosillo;16;12;4
40;Segovia;159;Pinarejos;186;109;77
40;Segovia;160;Pinarnegrillo;96;53;43
40;Segovia;162;Prádena;523;277;246
40;Segovia;163;Puebla de Pedraza;43;22;21
40;Segovia;164;Rapariegos;205;105;100
40;Segovia;181;Real Sitio de San Ildefonso;5241;2568;2673
40;Segovia;165;Rebollo;81;43;38
40;Segovia;166;Remondo;300;159;141
40;Segovia;168;Riaguas de San Bartolomé;28;19;9
40;Segovia;170;Riaza;2098;1118;980
40;Segovia;171;Ribota;48;35;13
40;Segovia;172;Riofrío de Riaza;45;26;19
40;Segovia;173;Roda de Eresma;188;99;89
40;Segovia;174;Sacramenia;365;187;178
40;Segovia;176;Samboal;457;244;213
40;Segovia;177;San Cristóbal de Cuéllar;151;82;69
40;Segovia;178;San Cristóbal de la Vega;101;54;47
40;Segovia;906;San Cristóbal de Segovia;3051;1528;1523
40;Segovia;182;San Martín y Mudrián;245;114;131
40;Segovia;183;San Miguel de Bernuy;140;70;70
40;Segovia;184;San Pedro de Gaíllos;285;156;129
40;Segovia;179;Sanchonuño;940;457;483
40;Segovia;180;Sangarcía;314;176;138
40;Segovia;185;Santa María la Real de Nieva;972;529;443
40;Segovia;186;Santa Marta del Cerro;35;19;16
40;Segovia;188;Santiuste de Pedraza;92;59;33
40;Segovia;189;Santiuste de San Juan Bautista;545;302;243
40;Segovia;190;Santo Domingo de Pirón;58;33;25
40;Segovia;191;Santo Tomé del Puerto;252;140;112
40;Segovia;192;Sauquillo de Cabezas;150;83;67
40;Segovia;193;Sebúlcor;273;143;130
40;Segovia;194;Segovia;51674;24181;27493
40;Segovia;195;Sepúlveda;1003;515;488
40;Segovia;196;Sequera de Fresno;35;23;12
40;Segovia;198;Sotillo;27;15;12
40;Segovia;199;Sotosalbos;120;61;59
40;Segovia;200;Tabanera la Luenga;56;27;29
40;Segovia;201;Tolocirio;47;23;24
40;Segovia;206;Torre Val de San Pedro;184;98;86
40;Segovia;202;Torreadrada;55;28;27
40;Segovia;203;Torrecaballeros;1347;700;647
40;Segovia;204;Torrecilla del Pinar;191;103;88
40;Segovia;205;Torreiglesias;245;125;120
40;Segovia;207;Trescasas;1071;550;521
40;Segovia;208;Turégano;979;489;490
40;Segovia;210;Urueñas;106;65;41
40;Segovia;211;Valdeprados;67;37;30
40;Segovia;212;Valdevacas de Montejo;30;15;15
40;Segovia;213;Valdevacas y Guijar;99;53;46
40;Segovia;218;Valle de Tabladillo;86;51;35
40;Segovia;219;Vallelado;694;368;326
40;Segovia;220;Valleruela de Pedraza;71;37;34
40;Segovia;221;Valleruela de Sepúlveda;51;25;26
40;Segovia;214;Valseca;233;129;104
40;Segovia;215;Valtiendas;88;51;37
40;Segovia;216;Valverde del Majano;1095;566;529
40;Segovia;222;Veganzones;219;118;101
40;Segovia;223;Vegas de Matute;273;161;112
40;Segovia;224;Ventosilla y Tejadilla;19;13;6
40;Segovia;225;Villacastín;1481;775;706
40;Segovia;228;Villaverde de Íscar;604;315;289
40;Segovia;229;Villaverde de Montejo;27;17;10
40;Segovia;230;Villeguillo;110;61;49
40;Segovia;231;Yanguas de Eresma;128;66;62
40;Segovia;233;Zarzuela del Monte;479;252;227
40;Segovia;234;Zarzuela del Pinar;429;220;209
41;Sevilla;001;Aguadulce;2020;1003;1017
41;Sevilla;002;Alanís;1723;867;856
41;Sevilla;003;Albaida del Aljarafe;3197;1601;1596
41;Sevilla;004;Alcalá de Guadaíra;75279;37379;37900
41;Sevilla;005;Alcalá del Río;12029;6116;5913
41;Sevilla;006;Alcolea del Río;3373;1683;1690
41;Sevilla;007;Algaba, La;16374;8123;8251
41;Sevilla;008;Algámitas;1255;643;612
41;Sevilla;009;Almadén de la Plata;1355;696;659
41;Sevilla;010;Almensilla;6080;3043;3037
41;Sevilla;011;Arahal;19526;9677;9849
41;Sevilla;012;Aznalcázar;4586;2318;2268
41;Sevilla;013;Aznalcóllar;6091;3102;2989
41;Sevilla;014;Badolatosa;3078;1589;1489
41;Sevilla;015;Benacazón;7241;3660;3581
41;Sevilla;016;Bollullos de la Mitación;10787;5406;5381
41;Sevilla;017;Bormujos;21972;10879;11093
41;Sevilla;018;Brenes;12471;6181;6290
41;Sevilla;019;Burguillos;6716;3388;3328
41;Sevilla;020;Cabezas de San Juan, Las;16417;8217;8200
41;Sevilla;021;Camas;27509;13425;14084
41;Sevilla;022;Campana, La;5276;2643;2633
41;Sevilla;023;Cantillana;10684;5454;5230
41;Sevilla;901;Cañada Rosal;3320;1641;1679
41;Sevilla;024;Carmona;28531;14349;14182
41;Sevilla;025;Carrión de los Céspedes;2544;1248;1296
41;Sevilla;026;Casariche;5456;2798;2658
41;Sevilla;027;Castilblanco de los Arroyos;4864;2443;2421
41;Sevilla;028;Castilleja de Guzmán;2821;1447;1374
41;Sevilla;029;Castilleja de la Cuesta;17418;8442;8976
41;Sevilla;030;Castilleja del Campo;629;323;306
41;Sevilla;031;Castillo de las Guardas, El;1443;752;691
41;Sevilla;032;Cazalla de la Sierra;4718;2335;2383
41;Sevilla;033;Constantina;5896;2916;2980
41;Sevilla;034;Coria del Río;30777;15336;15441
41;Sevilla;035;Coripe;1251;611;640
41;Sevilla;036;Coronil, El;4746;2386;2360
41;Sevilla;037;Corrales, Los;3941;2013;1928
41;Sevilla;903;Cuervo de Sevilla, El;8610;4329;4281
41;Sevilla;038;Dos Hermanas;133968;65828;68140
41;Sevilla;039;Écija;39873;19707;20166
41;Sevilla;040;Espartinas;15791;7898;7893
41;Sevilla;041;Estepa;12505;6229;6276
41;Sevilla;042;Fuentes de Andalucía;7111;3546;3565
41;Sevilla;043;Garrobo, El;790;400;390
41;Sevilla;044;Gelves;10184;5082;5102
41;Sevilla;045;Gerena;7585;3808;3777
41;Sevilla;046;Gilena;3727;1866;1861
41;Sevilla;047;Gines;13420;6605;6815
41;Sevilla;048;Guadalcanal;2627;1316;1311
41;Sevilla;049;Guillena;12788;6440;6348
41;Sevilla;050;Herrera;6461;3203;3258
41;Sevilla;051;Huévar del Aljarafe;3015;1547;1468
41;Sevilla;902;Isla Mayor;5839;2905;2934
41;Sevilla;052;Lantejuela;3814;1945;1869
41;Sevilla;053;Lebrija;27524;13735;13789
41;Sevilla;054;Lora de Estepa;862;441;421
41;Sevilla;055;Lora del Río;18662;9233;9429
41;Sevilla;056;Luisiana, La;4576;2313;2263
41;Sevilla;057;Madroño, El;278;140;138
41;Sevilla;058;Mairena del Alcor;23550;11781;11769
41;Sevilla;059;Mairena del Aljarafe;46089;22428;23661
41;Sevilla;060;Marchena;19457;9689;9768
41;Sevilla;061;Marinaleda;2627;1330;1297
41;Sevilla;062;Martín de la Jara;2704;1387;1317
41;Sevilla;063;Molares, Los;3480;1775;1705
41;Sevilla;064;Montellano;7056;3519;3537
41;Sevilla;065;Morón de la Frontera;27627;13628;13999
41;Sevilla;066;Navas de la Concepción, Las;1559;775;784
41;Sevilla;067;Olivares;9394;4711;4683
41;Sevilla;068;Osuna;17560;8741;8819
41;Sevilla;069;Palacios y Villafranca, Los;38354;19244;19110
41;Sevilla;904;Palmar de Troya, El;2340;1165;1175
41;Sevilla;070;Palomares del Río;8767;4395;4372
41;Sevilla;071;Paradas;6908;3430;3478
41;Sevilla;072;Pedrera;5194;2576;2618
41;Sevilla;073;Pedroso, El;2018;996;1022
41;Sevilla;074;Peñaflor;3656;1845;1811
41;Sevilla;075;Pilas;13974;7041;6933
41;Sevilla;076;Pruna;2603;1327;1276
41;Sevilla;077;Puebla de Cazalla, La;10979;5469;5510
41;Sevilla;078;Puebla de los Infantes, La;2991;1486;1505
41;Sevilla;079;Puebla del Río, La;11868;5869;5999
41;Sevilla;080;Real de la Jara, El;1503;742;761
41;Sevilla;081;Rinconada, La;38628;19049;19579
41;Sevilla;082;Roda de Andalucía, La;4183;2062;2121
41;Sevilla;083;Ronquillo, El;1364;685;679
41;Sevilla;084;Rubio, El;3408;1690;1718
41;Sevilla;085;Salteras;5530;2679;2851
41;Sevilla;086;San Juan de Aznalfarache;21416;10309;11107
41;Sevilla;088;San Nicolás del Puerto;596;309;287
41;Sevilla;087;Sanlúcar la Mayor;13808;6833;6975
41;Sevilla;089;Santiponce;8554;4248;4306
41;Sevilla;090;Saucejo, El;4284;2121;2163
41;Sevilla;091;Sevilla;688592;326634;361958
41;Sevilla;092;Tocina;9501;4700;4801
41;Sevilla;093;Tomares;25359;12511;12848
41;Sevilla;094;Umbrete;8894;4452;4442
41;Sevilla;095;Utrera;50728;25161;25567
41;Sevilla;096;Valencina de la Concepción;7751;3792;3959
41;Sevilla;097;Villamanrique de la Condesa;4459;2201;2258
41;Sevilla;100;Villanueva de San Juan;1120;550;570
41;Sevilla;098;Villanueva del Ariscal;6610;3209;3401
41;Sevilla;099;Villanueva del Río y Minas;4858;2459;2399
41;Sevilla;101;Villaverde del Río;7818;3932;3886
41;Sevilla;102;Viso del Alcor, El;19266;9628;9638
42;Soria;001;Abejar;297;155;142
42;Soria;003;Adradas;69;36;33
42;Soria;004;Ágreda;3001;1535;1466
42;Soria;006;Alconaba;176;114;62
42;Soria;007;Alcubilla de Avellaneda;104;56;48
42;Soria;008;Alcubilla de las Peñas;57;35;22
42;Soria;009;Aldealafuente;92;53;39
42;Soria;010;Aldealices;36;22;14
42;Soria;011;Aldealpozo;17;8;9
42;Soria;012;Aldealseñor;31;16;15
42;Soria;013;Aldehuela de Periáñez;41;23;18
42;Soria;014;Aldehuelas, Las;64;34;30
42;Soria;015;Alentisque;33;20;13
42;Soria;016;Aliud;20;15;5
42;Soria;017;Almajano;187;98;89
42;Soria;018;Almaluez;132;74;58
42;Soria;019;Almarza;591;345;246
42;Soria;020;Almazán;5489;2784;2705
42;Soria;021;Almazul;67;41;26
42;Soria;022;Almenar de Soria;228;135;93
42;Soria;023;Alpanseque;62;38;24
42;Soria;024;Arancón;88;59;29
42;Soria;025;Arcos de Jalón;1469;761;708
42;Soria;026;Arenillas;21;11;10
42;Soria;027;Arévalo de la Sierra;78;49;29
42;Soria;028;Ausejo de la Sierra;89;47;42
42;Soria;029;Baraona;135;76;59
42;Soria;030;Barca;98;62;36
42;Soria;031;Barcones;22;15;7
42;Soria;032;Bayubas de Abajo;142;77;65
42;Soria;033;Bayubas de Arriba;57;34;23
42;Soria;034;Beratón;47;26;21
42;Soria;035;Berlanga de Duero;856;436;420
42;Soria;036;Blacos;39;21;18
42;Soria;037;Bliecos;33;19;14
42;Soria;038;Borjabad;33;20;13
42;Soria;039;Borobia;239;127;112
42;Soria;041;Buberos;31;17;14
42;Soria;042;Buitrago;65;34;31
42;Soria;043;Burgo de Osma-Ciudad de Osma;4940;2463;2477
42;Soria;044;Cabrejas del Campo;53;34;19
42;Soria;045;Cabrejas del Pinar;347;198;149
42;Soria;046;Calatañazor;51;29;22
42;Soria;048;Caltojar;52;36;16
42;Soria;049;Candilichera;113;66;47
42;Soria;050;Cañamaque;30;19;11
42;Soria;051;Carabantes;15;8;7
42;Soria;052;Caracena;17;11;6
42;Soria;053;Carrascosa de Abajo;21;14;7
42;Soria;054;Carrascosa de la Sierra;19;14;5
42;Soria;055;Casarejos;169;88;81
42;Soria;056;Castilfrío de la Sierra;29;20;9
42;Soria;058;Castillejo de Robledo;103;60;43
42;Soria;057;Castilruiz;162;84;78
42;Soria;059;Centenera de Andaluz;20;10;10
42;Soria;060;Cerbón;28;19;9
42;Soria;061;Cidones;301;183;118
42;Soria;062;Cigudosa;19;12;7
42;Soria;063;Cihuela;51;28;23
42;Soria;064;Ciria;88;45;43
42;Soria;065;Cirujales del Río;22;16;6
42;Soria;068;Coscurita;79;49;30
42;Soria;069;Covaleda;1680;868;812
42;Soria;070;Cubilla;33;20;13
42;Soria;071;Cubo de la Solana;184;101;83
42;Soria;073;Cueva de Ágreda;73;46;27
42;Soria;075;Dévanos;79;45;34
42;Soria;076;Deza;214;112;102
42;Soria;078;Duruelo de la Sierra;1090;556;534
42;Soria;079;Escobosa de Almazán;21;14;7
42;Soria;080;Espeja de San Marcelino;155;91;64
42;Soria;081;Espejón;161;86;75
42;Soria;082;Estepa de San Juan;7;6;1
42;Soria;083;Frechilla de Almazán;24;13;11
42;Soria;084;Fresno de Caracena;21;14;7
42;Soria;085;Fuentearmegil;178;102;76
42;Soria;086;Fuentecambrón;34;21;13
42;Soria;087;Fuentecantos;61;31;30
42;Soria;088;Fuentelmonge;61;36;25
42;Soria;089;Fuentelsaz de Soria;66;33;33
42;Soria;090;Fuentepinilla;88;57;31
42;Soria;092;Fuentes de Magaña;64;38;26
42;Soria;093;Fuentestrún;43;29;14
42;Soria;094;Garray;732;395;337
42;Soria;095;Golmayo;2626;1369;1257
42;Soria;096;Gómara;310;169;141
42;Soria;097;Gormaz;16;12;4
42;Soria;098;Herrera de Soria;9;7;2
42;Soria;100;Hinojosa del Campo;31;20;11
42;Soria;103;Langa de Duero;704;387;317
42;Soria;105;Liceras;49;25;24
42;Soria;106;Losilla, La;14;10;4
42;Soria;107;Magaña;69;39;30
42;Soria;108;Maján;10;6;4
42;Soria;110;Matalebreras;66;40;26
42;Soria;111;Matamala de Almazán;288;152;136
42;Soria;113;Medinaceli;713;363;350
42;Soria;115;Miño de Medinaceli;100;63;37
42;Soria;116;Miño de San Esteban;46;30;16
42;Soria;117;Molinos de Duero;162;89;73
42;Soria;118;Momblona;22;15;7
42;Soria;119;Monteagudo de las Vicarías;185;93;92
42;Soria;120;Montejo de Tiermes;155;100;55
42;Soria;121;Montenegro de Cameros;57;36;21
42;Soria;123;Morón de Almazán;193;100;93
42;Soria;124;Muriel de la Fuente;61;35;26
42;Soria;125;Muriel Viejo;85;56;29
42;Soria;127;Nafría de Ucero;36;21;15
42;Soria;128;Narros;50;28;22
42;Soria;129;Navaleno;769;407;362
42;Soria;130;Nepas;51;36;15
42;Soria;131;Nolay;57;31;26
42;Soria;132;Noviercas;156;88;68
42;Soria;134;Ólvega;3656;1902;1754
42;Soria;135;Oncala;75;43;32
42;Soria;139;Pinilla del Campo;21;12;9
42;Soria;140;Portillo de Soria;14;9;5
42;Soria;141;Póveda de Soria, La;123;74;49
42;Soria;142;Pozalmuro;56;27;29
42;Soria;144;Quintana Redonda;489;274;215
42;Soria;145;Quintanas de Gormaz;146;90;56
42;Soria;148;Quiñonería;9;5;4
42;Soria;149;Rábanos, Los;453;257;196
42;Soria;151;Rebollar;42;20;22
42;Soria;152;Recuerda;79;46;33
42;Soria;153;Rello;14;9;5
42;Soria;154;Renieblas;104;63;41
42;Soria;155;Retortillo de Soria;149;87;62
42;Soria;156;Reznos;32;22;10
42;Soria;157;Riba de Escalote, La;9;7;2
42;Soria;158;Rioseco de Soria;123;73;50
42;Soria;159;Rollamienta;40;27;13
42;Soria;160;Royo, El;265;144;121
42;Soria;161;Salduero;143;78;65
42;Soria;162;San Esteban de Gormaz;3005;1576;1429
42;Soria;163;San Felices;51;32;19
42;Soria;164;San Leonardo de Yagüe;2044;1038;1006
42;Soria;165;San Pedro Manrique;620;348;272
42;Soria;166;Santa Cruz de Yanguas;61;38;23
42;Soria;167;Santa María de Huerta;266;147;119
42;Soria;168;Santa María de las Hoyas;97;57;40
42;Soria;171;Serón de Nágima;124;73;51
42;Soria;172;Soliedra;32;18;14
42;Soria;173;Soria;39398;18579;20819
42;Soria;174;Sotillo del Rincón;190;100;90
42;Soria;175;Suellacabras;25;15;10
42;Soria;176;Tajahuerce;27;15;12
42;Soria;177;Tajueco;64;35;29
42;Soria;178;Talveila;105;63;42
42;Soria;181;Tardelcuende;431;229;202
42;Soria;182;Taroda;50;28;22
42;Soria;183;Tejado;108;62;46
42;Soria;184;Torlengua;59;33;26
42;Soria;185;Torreblacos;25;13;12
42;Soria;187;Torrubia de Soria;65;46;19
42;Soria;188;Trévago;43;18;25
42;Soria;189;Ucero;50;26;24
42;Soria;190;Vadillo;96;50;46
42;Soria;191;Valdeavellano de Tera;191;104;87
42;Soria;192;Valdegeña;38;28;10
42;Soria;193;Valdelagua del Cerro;18;11;7
42;Soria;194;Valdemaluque;151;68;83
42;Soria;195;Valdenebro;106;59;47
42;Soria;196;Valdeprado;8;5;3
42;Soria;197;Valderrodilla;68;36;32
42;Soria;198;Valtajeros;19;13;6
42;Soria;200;Velamazán;76;50;26
42;Soria;201;Velilla de la Sierra;24;15;9
42;Soria;202;Velilla de los Ajos;20;10;10
42;Soria;204;Viana de Duero;54;39;15
42;Soria;205;Villaciervos;87;53;34
42;Soria;206;Villanueva de Gormaz;8;6;2
42;Soria;207;Villar del Ala;51;27;24
42;Soria;208;Villar del Campo;22;14;8
42;Soria;209;Villar del Río;139;85;54
42;Soria;211;Villares de Soria, Los;88;49;39
42;Soria;212;Villasayas;67;44;23
42;Soria;213;Villaseca de Arciel;28;16;12
42;Soria;215;Vinuesa;855;459;396
42;Soria;216;Vizmanos;25;17;8
42;Soria;217;Vozmediano;38;24;14
42;Soria;218;Yanguas;113;75;38
42;Soria;219;Yelo;40;24;16
43;Tarragona;001;Aiguamúrcia;901;465;436
43;Tarragona;002;Albinyana;2438;1243;1195
43;Tarragona;003;Albiol, L';485;253;232
43;Tarragona;004;Alcanar;9418;4748;4670
43;Tarragona;005;Alcover;5064;2499;2565
43;Tarragona;904;Aldea, L';4160;2197;1963
43;Tarragona;006;Aldover;882;445;437
43;Tarragona;007;Aleixar, L';873;450;423
43;Tarragona;008;Alfara de Carles;377;199;178
43;Tarragona;009;Alforja;1801;921;880
43;Tarragona;010;Alió;439;208;231
43;Tarragona;011;Almoster;1351;680;671
43;Tarragona;012;Altafulla;5243;2555;2688
43;Tarragona;013;Ametlla de Mar, L';6787;3384;3403
43;Tarragona;906;Ampolla, L';3205;1631;1574
43;Tarragona;014;Amposta;20738;10449;10289
43;Tarragona;016;Arboç, L';5517;2852;2665
43;Tarragona;015;Arbolí;137;79;58
43;Tarragona;017;Argentera, L';124;70;54
43;Tarragona;018;Arnes;455;224;231
43;Tarragona;019;Ascó;1660;856;804
43;Tarragona;020;Banyeres del Penedès;3170;1612;1558
43;Tarragona;021;Barberà de la Conca;473;257;216
43;Tarragona;022;Batea;1890;944;946
43;Tarragona;023;Bellmunt del Priorat;280;145;135
43;Tarragona;024;Bellvei;2203;1132;1071
43;Tarragona;025;Benifallet;739;348;391
43;Tarragona;026;Benissanet;1161;646;515
43;Tarragona;027;Bisbal de Falset, La;216;116;100
43;Tarragona;028;Bisbal del Penedès, La;3528;1862;1666
43;Tarragona;029;Blancafort;389;198;191
43;Tarragona;030;Bonastre;688;357;331
43;Tarragona;031;Borges del Camp, Les;2037;1050;987
43;Tarragona;032;Bot;573;295;278
43;Tarragona;033;Botarell;1068;549;519
43;Tarragona;034;Bràfim;692;357;335
43;Tarragona;035;Cabacés;298;155;143
43;Tarragona;036;Cabra del Camp;1163;608;555
43;Tarragona;037;Calafell;26538;13362;13176
43;Tarragona;903;Camarles;3224;1638;1586
43;Tarragona;038;Cambrils;33898;16553;17345
43;Tarragona;907;Canonja, La;5893;2892;3001
43;Tarragona;039;Capafonts;121;62;59
43;Tarragona;040;Capçanes;398;202;196
43;Tarragona;041;Caseres;259;129;130
43;Tarragona;042;Castellvell del Camp;2857;1438;1419
43;Tarragona;043;Catllar, El;4451;2309;2142
43;Tarragona;045;Colldejou;176;93;83
43;Tarragona;046;Conesa;103;54;49
43;Tarragona;047;Constantí;6540;3398;3142
43;Tarragona;048;Corbera d'Ebre;1016;531;485
43;Tarragona;049;Cornudella de Montsant;941;505;436
43;Tarragona;050;Creixell;3642;1845;1797
43;Tarragona;051;Cunit;12952;6347;6605
43;Tarragona;901;Deltebre;11482;5788;5694
43;Tarragona;053;Duesaigües;245;140;105
43;Tarragona;054;Espluga de Francolí, L';3755;1824;1931
43;Tarragona;055;Falset;2834;1412;1422
43;Tarragona;056;Fatarella, La;941;458;483
43;Tarragona;057;Febró, La;40;25;15
43;Tarragona;058;Figuera, La;111;63;48
43;Tarragona;059;Figuerola del Camp;320;159;161
43;Tarragona;060;Flix;3408;1717;1691
43;Tarragona;061;Forès;43;25;18
43;Tarragona;062;Freginals;346;175;171
43;Tarragona;063;Galera, La;731;375;356
43;Tarragona;064;Gandesa;3064;1563;1501
43;Tarragona;065;Garcia;527;264;263
43;Tarragona;066;Garidells, Els;187;94;93
43;Tarragona;067;Ginestar;753;403;350
43;Tarragona;068;Godall;575;289;286
43;Tarragona;069;Gratallops;229;125;104
43;Tarragona;070;Guiamets, Els;270;128;142
43;Tarragona;071;Horta de Sant Joan;1149;602;547
43;Tarragona;072;Lloar, El;107;58;49
43;Tarragona;073;Llorac;100;52;48
43;Tarragona;074;Llorenç del Penedès;2393;1172;1221
43;Tarragona;076;Marçà;594;314;280
43;Tarragona;075;Margalef;97;59;38
43;Tarragona;077;Mas de Barberans;578;288;290
43;Tarragona;078;Masdenverge;1070;546;524
43;Tarragona;079;Masllorenç;504;283;221
43;Tarragona;080;Masó, La;276;146;130
43;Tarragona;081;Maspujols;827;426;401
43;Tarragona;082;Masroig, El;497;270;227
43;Tarragona;083;Milà, El;178;85;93
43;Tarragona;084;Miravet;691;369;322
43;Tarragona;085;Molar, El;297;158;139
43;Tarragona;086;Montblanc;7364;3737;3627
43;Tarragona;088;Montbrió del Camp;2890;1485;1405
43;Tarragona;089;Montferri;387;202;185
43;Tarragona;090;Montmell, El;1512;808;704
43;Tarragona;091;Mont-ral;162;94;68
43;Tarragona;092;Mont-roig del Camp;12136;6260;5876
43;Tarragona;093;Móra d'Ebre;5690;2845;2845
43;Tarragona;094;Móra la Nova;3087;1541;1546
43;Tarragona;095;Morell, El;3704;1881;1823
43;Tarragona;096;Morera de Montsant, La;152;85;67
43;Tarragona;097;Nou de Gaià, La;603;300;303
43;Tarragona;098;Nulles;492;267;225
43;Tarragona;100;Pallaresos, Els;4777;2404;2373
43;Tarragona;099;Palma d'Ebre, La;340;166;174
43;Tarragona;101;Passanant i Belltall;163;95;68
43;Tarragona;102;Paüls;556;277;279
43;Tarragona;103;Perafort;1261;654;607
43;Tarragona;104;Perelló, El;2770;1421;1349
43;Tarragona;105;Piles, Les;212;120;92
43;Tarragona;106;Pinell de Brai, El;1017;516;501
43;Tarragona;107;Pira;493;261;232
43;Tarragona;108;Pla de Santa Maria, El;2327;1215;1112
43;Tarragona;109;Pobla de Mafumet, La;3904;1982;1922
43;Tarragona;110;Pobla de Massaluca, La;318;181;137
43;Tarragona;111;Pobla de Montornès, La;2839;1486;1353
43;Tarragona;112;Poboleda;313;166;147
43;Tarragona;113;Pont d'Armentera, El;505;258;247
43;Tarragona;141;Pontils;117;66;51
43;Tarragona;114;Porrera;439;229;210
43;Tarragona;115;Pradell de la Teixeta;152;70;82
43;Tarragona;116;Prades;589;309;280
43;Tarragona;117;Prat de Comte;183;98;85
43;Tarragona;118;Pratdip;738;395;343
43;Tarragona;119;Puigpelat;1149;590;559
43;Tarragona;120;Querol;507;285;222
43;Tarragona;121;Rasquera;781;384;397
43;Tarragona;122;Renau;157;82;75
43;Tarragona;123;Reus;104373;50415;53958
43;Tarragona;124;Riba, La;585;321;264
43;Tarragona;125;Riba-roja d'Ebre;1126;593;533
43;Tarragona;126;Riera de Gaià, La;1744;867;877
43;Tarragona;127;Riudecanyes;1124;590;534
43;Tarragona;128;Riudecols;1180;611;569
43;Tarragona;129;Riudoms;6594;3380;3214
43;Tarragona;130;Rocafort de Queralt;225;122;103
43;Tarragona;131;Roda de Berà;6567;3341;3226
43;Tarragona;132;Rodonyà;490;262;228
43;Tarragona;133;Roquetes;7973;4126;3847
43;Tarragona;134;Rourell, El;366;191;175
43;Tarragona;135;Salomó;557;295;262
43;Tarragona;905;Salou;27476;14141;13335
43;Tarragona;136;Sant Carles de la Ràpita;14789;7238;7551
43;Tarragona;137;Sant Jaume dels Domenys;2622;1342;1280
43;Tarragona;902;Sant Jaume d'Enveja;3503;1765;1738
43;Tarragona;138;Santa Bàrbara;3707;1881;1826
43;Tarragona;139;Santa Coloma de Queralt;2673;1328;1345
43;Tarragona;140;Santa Oliva;3320;1685;1635
43;Tarragona;142;Sarral;1548;789;759
43;Tarragona;143;Savallà del Comtat;58;31;27
43;Tarragona;144;Secuita, La;1687;851;836
43;Tarragona;145;Selva del Camp, La;5652;2836;2816
43;Tarragona;146;Senan;48;33;15
43;Tarragona;044;Sénia, La;5681;2844;2837
43;Tarragona;147;Solivella;633;333;300
43;Tarragona;148;Tarragona;134515;65505;69010
43;Tarragona;149;Tivenys;899;458;441
43;Tarragona;150;Tivissa;1602;799;803
43;Tarragona;151;Torre de Fontaubella, La;138;68;70
43;Tarragona;152;Torre de l'Espanyol, La;611;311;300
43;Tarragona;153;Torredembarra;16184;7925;8259
43;Tarragona;154;Torroja del Priorat;149;81;68
43;Tarragona;155;Tortosa;33372;16496;16876
43;Tarragona;156;Ulldecona;6300;3286;3014
43;Tarragona;157;Ulldemolins;396;229;167
43;Tarragona;158;Vallclara;98;57;41
43;Tarragona;159;Vallfogona de Riucorb;91;55;36
43;Tarragona;160;Vallmoll;1756;890;866
43;Tarragona;161;Valls;24359;12210;12149
43;Tarragona;162;Vandellòs i l'Hospitalet de l'Infant;6482;3246;3236
43;Tarragona;163;Vendrell, El;37606;18631;18975
43;Tarragona;164;Vespella de Gaià;410;232;178
43;Tarragona;165;Vilabella;736;378;358
43;Tarragona;175;Vilalba dels Arcs;625;318;307
43;Tarragona;166;Vilallonga del Camp;2389;1206;1183
43;Tarragona;168;Vilanova de Prades;112;60;52
43;Tarragona;167;Vilanova d'Escornalbou;545;288;257
43;Tarragona;169;Vilaplana;574;302;272
43;Tarragona;170;Vila-rodona;1255;660;595
43;Tarragona;171;Vila-seca;22187;11113;11074
43;Tarragona;172;Vilaverd;452;240;212
43;Tarragona;173;Vilella Alta, La;135;73;62
43;Tarragona;174;Vilella Baixa, La;202;113;89
43;Tarragona;176;Vimbodí i Poblet;892;488;404
43;Tarragona;177;Vinebre;428;221;207
43;Tarragona;178;Vinyols i els Arcs;2056;1070;986
43;Tarragona;052;Xerta;1170;571;599
44;Teruel;001;Ababuj;73;45;28
44;Teruel;002;Abejuela;48;31;17
44;Teruel;003;Aguatón;18;6;12
44;Teruel;004;Aguaviva;514;247;267
44;Teruel;005;Aguilar del Alfambra;63;36;27
44;Teruel;006;Alacón;252;129;123
44;Teruel;007;Alba;170;94;76
44;Teruel;008;Albalate del Arzobispo;1980;1013;967
44;Teruel;009;Albarracín;1025;521;504
44;Teruel;010;Albentosa;276;149;127
44;Teruel;011;Alcaine;59;36;23
44;Teruel;012;Alcalá de la Selva;343;188;155
44;Teruel;013;Alcañiz;15947;7911;8036
44;Teruel;014;Alcorisa;3266;1661;1605
44;Teruel;016;Alfambra;508;264;244
44;Teruel;017;Aliaga;341;188;153
44;Teruel;021;Allepuz;125;63;62
44;Teruel;022;Alloza;558;292;266
44;Teruel;023;Allueva;26;17;9
44;Teruel;018;Almohaja;16;11;5
44;Teruel;019;Alobras;64;40;24
44;Teruel;020;Alpeñés;22;13;9
44;Teruel;024;Anadón;28;18;10
44;Teruel;025;Andorra;7472;3773;3699
44;Teruel;026;Arcos de las Salinas;119;68;51
44;Teruel;027;Arens de Lledó;211;108;103
44;Teruel;028;Argente;195;96;99
44;Teruel;029;Ariño;724;365;359
44;Teruel;031;Azaila;90;46;44
44;Teruel;032;Bádenas;19;12;7
44;Teruel;033;Báguena;287;161;126
44;Teruel;034;Bañón;144;79;65
44;Teruel;035;Barrachina;112;60;52
44;Teruel;036;Bea;31;18;13
44;Teruel;037;Beceite;541;273;268
44;Teruel;039;Bello;224;111;113
44;Teruel;038;Belmonte de San José;113;53;60
44;Teruel;040;Berge;235;119;116
44;Teruel;041;Bezas;70;45;25
44;Teruel;042;Blancas;126;75;51
44;Teruel;043;Blesa;94;60;34
44;Teruel;044;Bordón;100;56;44
44;Teruel;045;Bronchales;432;248;184
44;Teruel;046;Bueña;50;27;23
44;Teruel;047;Burbáguena;249;131;118
44;Teruel;048;Cabra de Mora;54;34;20
44;Teruel;049;Calaceite;994;488;506
44;Teruel;050;Calamocha;4339;2166;2173
44;Teruel;051;Calanda;3748;1852;1896
44;Teruel;052;Calomarde;75;44;31
44;Teruel;053;Camañas;134;78;56
44;Teruel;054;Camarena de la Sierra;105;65;40
44;Teruel;055;Camarillas;100;61;39
44;Teruel;056;Caminreal;620;324;296
44;Teruel;059;Cantavieja;709;368;341
44;Teruel;060;Cañada de Benatanduz;36;24;12
44;Teruel;061;Cañada de Verich, La;89;55;34
44;Teruel;062;Cañada Vellida;31;22;9
44;Teruel;063;Cañizar del Olivar;100;53;47
44;Teruel;064;Cascante del Río;67;42;25
44;Teruel;065;Castejón de Tornos;60;38;22
44;Teruel;066;Castel de Cabra;96;53;43
44;Teruel;070;Castellar, El;58;38;20
44;Teruel;071;Castellote;681;348;333
44;Teruel;067;Castelnou;141;74;67
44;Teruel;068;Castelserás;815;430;385
44;Teruel;074;Cedrillas;664;325;339
44;Teruel;075;Celadas;388;221;167
44;Teruel;076;Cella;2574;1329;1245
44;Teruel;077;Cerollera, La;93;58;35
44;Teruel;080;Codoñera, La;336;177;159
44;Teruel;082;Corbalán;107;56;51
44;Teruel;084;Cortes de Aragón;61;28;33
44;Teruel;085;Cosa;50;32;18
44;Teruel;086;Cretas;567;290;277
44;Teruel;087;Crivillén;62;32;30
44;Teruel;088;Cuba, La;43;26;17
44;Teruel;089;Cubla;58;39;19
44;Teruel;090;Cucalón;78;47;31
44;Teruel;092;Cuervo, El;78;42;36
44;Teruel;093;Cuevas de Almudén;126;71;55
44;Teruel;094;Cuevas Labradas;132;72;60
44;Teruel;096;Ejulve;175;90;85
44;Teruel;097;Escorihuela;136;67;69
44;Teruel;099;Escucha;852;448;404
44;Teruel;100;Estercuel;203;111;92
44;Teruel;101;Ferreruela de Huerva;56;33;23
44;Teruel;102;Fonfría;27;15;12
44;Teruel;103;Formiche Alto;141;80;61
44;Teruel;105;Fórnoles;80;43;37
44;Teruel;106;Fortanete;205;119;86
44;Teruel;107;Foz-Calanda;245;128;117
44;Teruel;108;Fresneda, La;438;245;193
44;Teruel;109;Frías de Albarracín;115;69;46
44;Teruel;110;Fuenferrada;37;22;15
44;Teruel;111;Fuentes Calientes;92;53;39
44;Teruel;112;Fuentes Claras;461;252;209
44;Teruel;113;Fuentes de Rubielos;118;61;57
44;Teruel;114;Fuentespalda;284;143;141
44;Teruel;115;Galve;162;84;78
44;Teruel;116;Gargallo;93;51;42
44;Teruel;117;Gea de Albarracín;360;194;166
44;Teruel;118;Ginebrosa, La;194;106;88
44;Teruel;119;Griegos;136;80;56
44;Teruel;120;Guadalaviar;241;134;107
44;Teruel;121;Gúdar;76;47;29
44;Teruel;122;Híjar;1721;866;855
44;Teruel;123;Hinojosa de Jarque;111;63;48
44;Teruel;124;Hoz de la Vieja, La;83;42;41
44;Teruel;125;Huesa del Común;73;46;27
44;Teruel;126;Iglesuela del Cid, La;410;216;194
44;Teruel;127;Jabaloyas;63;38;25
44;Teruel;128;Jarque de la Val;66;35;31
44;Teruel;129;Jatiel;37;23;14
44;Teruel;130;Jorcas;30;18;12
44;Teruel;131;Josa;34;21;13
44;Teruel;132;Lagueruela;73;38;35
44;Teruel;133;Lanzuela;22;16;6
44;Teruel;135;Libros;102;64;38
44;Teruel;136;Lidón;57;31;26
44;Teruel;137;Linares de Mora;234;137;97
44;Teruel;141;Lledó;159;82;77
44;Teruel;138;Loscos;122;74;48
44;Teruel;142;Maicas;28;15;13
44;Teruel;143;Manzanera;531;285;246
44;Teruel;144;Martín del Río;401;195;206
44;Teruel;145;Mas de las Matas;1262;657;605
44;Teruel;146;Mata de los Olmos, La;257;130;127
44;Teruel;147;Mazaleón;522;277;245
44;Teruel;148;Mezquita de Jarque;96;57;39
44;Teruel;149;Mirambel;116;67;49
44;Teruel;150;Miravete de la Sierra;31;21;10
44;Teruel;151;Molinos;239;125;114
44;Teruel;152;Monforte de Moyuela;67;45;22
44;Teruel;153;Monreal del Campo;2434;1208;1226
44;Teruel;154;Monroyo;340;200;140
44;Teruel;155;Montalbán;1233;622;611
44;Teruel;156;Monteagudo del Castillo;54;30;24
44;Teruel;157;Monterde de Albarracín;64;40;24
44;Teruel;158;Mora de Rubielos;1548;766;782
44;Teruel;159;Moscardón;54;30;24
44;Teruel;160;Mosqueruela;537;293;244
44;Teruel;161;Muniesa;583;308;275
44;Teruel;163;Noguera de Albarracín;140;81;59
44;Teruel;164;Nogueras;22;16;6
44;Teruel;165;Nogueruelas;217;123;94
44;Teruel;167;Obón;44;23;21
44;Teruel;168;Odón;206;107;99
44;Teruel;169;Ojos Negros;360;198;162
44;Teruel;171;Olba;228;128;100
44;Teruel;172;Oliete;351;183;168
44;Teruel;173;Olmos, Los;120;65;55
44;Teruel;174;Orihuela del Tremedal;463;251;212
44;Teruel;175;Orrios;125;67;58
44;Teruel;176;Palomar de Arroyos;168;99;69
44;Teruel;177;Pancrudo;113;65;48
44;Teruel;178;Parras de Castellote, Las;55;31;24
44;Teruel;179;Peñarroya de Tastavins;439;241;198
44;Teruel;180;Peracense;77;42;35
44;Teruel;181;Peralejos;79;47;32
44;Teruel;182;Perales del Alfambra;229;123;106
44;Teruel;183;Pitarque;73;38;35
44;Teruel;184;Plou;43;27;16
44;Teruel;185;Pobo, El;110;70;40
44;Teruel;187;Portellada, La;235;118;117
44;Teruel;189;Pozondón;50;30;20
44;Teruel;190;Pozuel del Campo;65;35;30
44;Teruel;191;Puebla de Híjar, La;897;450;447
44;Teruel;192;Puebla de Valverde, La;457;253;204
44;Teruel;193;Puertomingalvo;109;55;54
44;Teruel;194;Ráfales;138;81;57
44;Teruel;195;Rillo;88;53;35
44;Teruel;196;Riodeva;142;69;73
44;Teruel;197;Ródenas;63;35;28
44;Teruel;198;Royuela;204;117;87
44;Teruel;199;Rubiales;52;30;22
44;Teruel;200;Rubielos de la Cérida;39;24;15
44;Teruel;201;Rubielos de Mora;621;326;295
44;Teruel;203;Salcedillo;14;9;5
44;Teruel;204;Saldón;27;18;9
44;Teruel;205;Samper de Calanda;755;387;368
44;Teruel;206;San Agustín;119;72;47
44;Teruel;207;San Martín del Río;137;72;65
44;Teruel;208;Santa Cruz de Nogueras;29;13;16
44;Teruel;209;Santa Eulalia;1061;544;517
44;Teruel;210;Sarrión;1128;590;538
44;Teruel;211;Segura de los Baños;38;24;14
44;Teruel;212;Seno;43;19;24
44;Teruel;213;Singra;75;44;31
44;Teruel;215;Terriente;183;103;80
44;Teruel;216;Teruel;35890;17080;18810
44;Teruel;217;Toril y Masegoso;32;26;6
44;Teruel;218;Tormón;30;17;13
44;Teruel;219;Tornos;206;108;98
44;Teruel;220;Torralba de los Sisones;155;86;69
44;Teruel;223;Torre de Arcas;90;44;46
44;Teruel;224;Torre de las Arcas;28;15;13
44;Teruel;225;Torre del Compte;120;58;62
44;Teruel;227;Torre los Negros;84;44;40
44;Teruel;221;Torrecilla de Alcañiz;433;224;209
44;Teruel;222;Torrecilla del Rebollar;124;81;43
44;Teruel;226;Torrelacárcel;151;82;69
44;Teruel;228;Torremocha de Jiloca;109;63;46
44;Teruel;229;Torres de Albarracín;180;103;77
44;Teruel;230;Torrevelilla;186;92;94
44;Teruel;231;Torrijas;41;19;22
44;Teruel;232;Torrijo del Campo;455;234;221
44;Teruel;234;Tramacastiel;72;42;30
44;Teruel;235;Tramacastilla;103;52;51
44;Teruel;236;Tronchón;67;33;34
44;Teruel;237;Urrea de Gaén;435;218;217
44;Teruel;238;Utrillas;2978;1545;1433
44;Teruel;239;Valacloche;22;12;10
44;Teruel;240;Valbona;167;93;74
44;Teruel;241;Valdealgorfa;612;301;311
44;Teruel;243;Valdecuenca;34;20;14
44;Teruel;244;Valdelinares;88;54;34
44;Teruel;245;Valdeltormo;283;136;147
44;Teruel;246;Valderrobres;2425;1240;1185
44;Teruel;247;Valjunquera;330;171;159
44;Teruel;249;Vallecillo, El;47;27;20
44;Teruel;250;Veguillas de la Sierra;19;12;7
44;Teruel;251;Villafranca del Campo;298;155;143
44;Teruel;252;Villahermosa del Campo;89;57;32
44;Teruel;256;Villanueva del Rebollar de la Sierra;39;24;15
44;Teruel;257;Villar del Cobo;164;97;67
44;Teruel;258;Villar del Salz;55;34;21
44;Teruel;260;Villarluengo;170;99;71
44;Teruel;261;Villarquemado;863;447;416
44;Teruel;262;Villarroya de los Pinares;172;92;80
44;Teruel;263;Villastar;505;252;253
44;Teruel;264;Villel;329;183;146
44;Teruel;265;Vinaceite;251;136;115
44;Teruel;266;Visiedo;119;53;66
44;Teruel;267;Vivel del Río Martín;73;37;36
44;Teruel;268;Zoma, La;33;18;15
45;Toledo;001;Ajofrín;2264;1135;1129
45;Toledo;002;Alameda de la Sagra;3623;1912;1711
45;Toledo;003;Albarreal de Tajo;683;353;330
45;Toledo;004;Alcabón;686;351;335
45;Toledo;005;Alcañizo;274;139;135
45;Toledo;006;Alcaudete de la Jara;1648;833;815
45;Toledo;007;Alcolea de Tajo;810;399;411
45;Toledo;008;Aldea en Cabo;163;86;77
45;Toledo;009;Aldeanueva de Barbarroya;520;267;253
45;Toledo;010;Aldeanueva de San Bartolomé;427;213;214
45;Toledo;011;Almendral de la Cañada;313;162;151
45;Toledo;012;Almonacid de Toledo;790;388;402
45;Toledo;013;Almorox;2105;1104;1001
45;Toledo;014;Añover de Tajo;5154;2620;2534
45;Toledo;015;Arcicóllar;883;437;446
45;Toledo;016;Argés;6418;3197;3221
45;Toledo;017;Azután;288;144;144
45;Toledo;018;Barcience;872;458;414
45;Toledo;019;Bargas;10332;5174;5158
45;Toledo;020;Belvís de la Jara;1522;764;758
45;Toledo;021;Borox;3825;2002;1823
45;Toledo;022;Buenaventura;424;216;208
45;Toledo;023;Burguillos de Toledo;3172;1636;1536
45;Toledo;024;Burujón;1319;670;649
45;Toledo;025;Cabañas de la Sagra;1799;922;877
45;Toledo;026;Cabañas de Yepes;257;135;122
45;Toledo;027;Cabezamesada;346;189;157
45;Toledo;028;Calera y Chozas;4646;2341;2305
45;Toledo;029;Caleruela;208;100;108
45;Toledo;030;Calzada de Oropesa;529;291;238
45;Toledo;031;Camarena;3960;2058;1902
45;Toledo;032;Camarenilla;565;283;282
45;Toledo;033;Campillo de la Jara, El;344;180;164
45;Toledo;034;Camuñas;1726;887;839
45;Toledo;035;Cardiel de los Montes;355;194;161
45;Toledo;036;Carmena;743;376;367
45;Toledo;037;Carpio de Tajo, El;1838;920;918
45;Toledo;038;Carranque;4846;2526;2320
45;Toledo;039;Carriches;262;131;131
45;Toledo;040;Casar de Escalona, El;1725;931;794
45;Toledo;041;Casarrubios del Monte;5681;2984;2697
45;Toledo;042;Casasbuenas;201;98;103
45;Toledo;043;Castillo de Bayuela;938;465;473
45;Toledo;045;Cazalegas;1750;905;845
45;Toledo;046;Cebolla;3235;1615;1620
45;Toledo;047;Cedillo del Condado;3762;1945;1817
45;Toledo;048;Cerralbos, Los;421;233;188
45;Toledo;049;Cervera de los Montes;517;260;257
45;Toledo;056;Chozas de Canales;3966;2065;1901
45;Toledo;057;Chueca;257;134;123
45;Toledo;050;Ciruelos;551;293;258
45;Toledo;051;Cobeja;2255;1163;1092
45;Toledo;052;Cobisa;4310;2164;2146
45;Toledo;053;Consuegra;9998;5061;4937
45;Toledo;054;Corral de Almaguer;5352;2763;2589
45;Toledo;055;Cuerva;1291;670;621
45;Toledo;058;Domingo Pérez;372;192;180
45;Toledo;059;Dosbarrios;2223;1137;1086
45;Toledo;060;Erustes;193;101;92
45;Toledo;061;Escalona;3241;1679;1562
45;Toledo;062;Escalonilla;1427;716;711
45;Toledo;063;Espinoso del Rey;436;247;189
45;Toledo;064;Esquivias;5549;2822;2727
45;Toledo;065;Estrella, La;225;117;108
45;Toledo;066;Fuensalida;11370;5768;5602
45;Toledo;067;Gálvez;3016;1501;1515
45;Toledo;068;Garciotum;206;108;98
45;Toledo;069;Gerindote;2300;1170;1130
45;Toledo;070;Guadamur;1792;900;892
45;Toledo;071;Guardia, La;2246;1133;1113
45;Toledo;072;Herencias, Las;785;419;366
45;Toledo;073;Herreruela de Oropesa;333;171;162
45;Toledo;074;Hinojosa de San Vicente;383;210;173
45;Toledo;075;Hontanar;141;83;58
45;Toledo;076;Hormigos;709;391;318
45;Toledo;077;Huecas;710;369;341
45;Toledo;078;Huerta de Valdecarábanos;1649;817;832
45;Toledo;079;Iglesuela del Tiétar, La;411;215;196
45;Toledo;080;Illán de Vacas;3;3;0
45;Toledo;081;Illescas;28894;14584;14310
45;Toledo;082;Lagartera;1369;683;686
45;Toledo;083;Layos;754;370;384
45;Toledo;084;Lillo;2577;1333;1244
45;Toledo;085;Lominchar;2387;1258;1129
45;Toledo;086;Lucillos;589;312;277
45;Toledo;087;Madridejos;10453;5228;5225
45;Toledo;088;Magán;3544;1786;1758
45;Toledo;089;Malpica de Tajo;1705;881;824
45;Toledo;090;Manzaneque;383;184;199
45;Toledo;091;Maqueda;438;219;219
45;Toledo;092;Marjaliza;247;120;127
45;Toledo;093;Marrupe;159;78;81
45;Toledo;094;Mascaraque;442;230;212
45;Toledo;095;Mata, La;838;415;423
45;Toledo;096;Mazarambroz;1241;641;600
45;Toledo;097;Mejorada;1275;661;614
45;Toledo;098;Menasalbas;2651;1399;1252
45;Toledo;099;Méntrida;5099;2614;2485
45;Toledo;100;Mesegar de Tajo;214;112;102
45;Toledo;101;Miguel Esteban;4856;2421;2435
45;Toledo;102;Mocejón;4875;2456;2419
45;Toledo;103;Mohedas de la Jara;402;222;180
45;Toledo;104;Montearagón;525;279;246
45;Toledo;105;Montesclaros;406;217;189
45;Toledo;106;Mora;9718;4875;4843
45;Toledo;107;Nambroca;4732;2439;2293
45;Toledo;108;Nava de Ricomalillo, La;535;274;261
45;Toledo;109;Navahermosa;3609;1866;1743
45;Toledo;110;Navalcán;1985;1044;941
45;Toledo;111;Navalmoralejo;54;28;26
45;Toledo;112;Navalmorales, Los;2518;1327;1191
45;Toledo;113;Navalucillos, Los;2106;1080;1026
45;Toledo;114;Navamorcuende;623;313;310
45;Toledo;115;Noblejas;3585;1818;1767
45;Toledo;116;Noez;878;446;432
45;Toledo;117;Nombela;858;452;406
45;Toledo;118;Novés;2905;1482;1423
45;Toledo;119;Numancia de la Sagra;4902;2570;2332
45;Toledo;120;Nuño Gómez;133;76;57
45;Toledo;121;Ocaña;11597;5849;5748
45;Toledo;122;Olías del Rey;7880;4043;3837
45;Toledo;123;Ontígola;4387;2336;2051
45;Toledo;124;Orgaz;2602;1293;1309
45;Toledo;125;Oropesa;2662;1296;1366
45;Toledo;126;Otero;331;176;155
45;Toledo;127;Palomeque;971;522;449
45;Toledo;128;Pantoja;3317;1660;1657
45;Toledo;129;Paredes de Escalona;111;54;57
45;Toledo;130;Parrillas;352;187;165
45;Toledo;131;Pelahustán;311;176;135
45;Toledo;132;Pepino;3055;1564;1491
45;Toledo;133;Polán;3848;1931;1917
45;Toledo;134;Portillo de Toledo;2209;1109;1100
45;Toledo;135;Puebla de Almoradiel, La;5168;2619;2549
45;Toledo;136;Puebla de Montalbán, La;7861;3989;3872
45;Toledo;137;Pueblanueva, La;2140;1077;1063
45;Toledo;138;Puente del Arzobispo, El;1246;621;625
45;Toledo;139;Puerto de San Vicente;156;83;73
45;Toledo;140;Pulgar;1508;771;737
45;Toledo;141;Quero;986;510;476
45;Toledo;142;Quintanar de la Orden;11030;5471;5559
45;Toledo;143;Quismondo;1527;780;747
45;Toledo;144;Real de San Vicente, El;922;494;428
45;Toledo;145;Recas;4262;2362;1900
45;Toledo;146;Retamoso de la Jara;104;56;48
45;Toledo;147;Rielves;752;381;371
45;Toledo;148;Robledo del Mazo;281;158;123
45;Toledo;149;Romeral, El;622;307;315
45;Toledo;150;San Bartolomé de las Abiertas;447;235;212
45;Toledo;151;San Martín de Montalbán;712;358;354
45;Toledo;152;San Martín de Pusa;642;338;304
45;Toledo;153;San Pablo de los Montes;1768;887;881
45;Toledo;154;San Román de los Montes;1881;999;882
45;Toledo;155;Santa Ana de Pusa;353;203;150
45;Toledo;156;Santa Cruz de la Zarza;4129;2097;2032
45;Toledo;157;Santa Cruz del Retamar;3079;1625;1454
45;Toledo;158;Santa Olalla;3251;1654;1597
45;Toledo;901;Santo Domingo-Caudilla;1038;551;487
45;Toledo;159;Sartajada;96;58;38
45;Toledo;160;Segurilla;1324;666;658
45;Toledo;161;Seseña;25835;13283;12552
45;Toledo;162;Sevilleja de la Jara;682;371;311
45;Toledo;163;Sonseca;11067;5585;5482
45;Toledo;164;Sotillo de las Palomas;183;92;91
45;Toledo;165;Talavera de la Reina;83417;40081;43336
45;Toledo;166;Tembleque;1986;1008;978
45;Toledo;167;Toboso, El;1764;874;890
45;Toledo;168;Toledo;84873;40527;44346
45;Toledo;169;Torralba de Oropesa;211;108;103
45;Toledo;171;Torre de Esteban Hambrán, La;1637;828;809
45;Toledo;170;Torrecilla de la Jara;224;119;105
45;Toledo;172;Torrico;709;364;345
45;Toledo;173;Torrijos;13466;6588;6878
45;Toledo;174;Totanés;348;172;176
45;Toledo;175;Turleque;749;377;372
45;Toledo;176;Ugena;5411;2793;2618
45;Toledo;177;Urda;2529;1262;1267
45;Toledo;179;Valdeverdeja;564;280;284
45;Toledo;180;Valmojado;4303;2162;2141
45;Toledo;181;Velada;2910;1506;1404
45;Toledo;182;Ventas con Peña Aguilera, Las;1109;569;540
45;Toledo;183;Ventas de Retamosa, Las;3365;1768;1597
45;Toledo;184;Ventas de San Julián, Las;228;111;117
45;Toledo;186;Villa de Don Fadrique, La;3664;1810;1854
45;Toledo;185;Villacañas;9548;4735;4813
45;Toledo;187;Villafranca de los Caballeros;4896;2421;2475
45;Toledo;188;Villaluenga de la Sagra;3815;1905;1910
45;Toledo;189;Villamiel de Toledo;873;447;426
45;Toledo;190;Villaminaya;527;264;263
45;Toledo;191;Villamuelas;612;322;290
45;Toledo;192;Villanueva de Alcardete;3250;1675;1575
45;Toledo;193;Villanueva de Bogas;712;370;342
45;Toledo;194;Villarejo de Montalbán;74;39;35
45;Toledo;195;Villarrubia de Santiago;2536;1264;1272
45;Toledo;196;Villaseca de la Sagra;1820;904;916
45;Toledo;197;Villasequilla;2478;1277;1201
45;Toledo;198;Villatobas;2403;1228;1175
45;Toledo;199;Viso de San Juan, El;4416;2364;2052
45;Toledo;200;Yébenes, Los;5901;3016;2885
45;Toledo;201;Yeles;5329;2804;2525
45;Toledo;202;Yepes;5198;2684;2514
45;Toledo;203;Yuncler;3940;2026;1914
45;Toledo;204;Yunclillos;809;421;388
45;Toledo;205;Yuncos;11222;5736;5486
46;Valencia/València;001;Ademuz;1042;568;474
46;Valencia/València;002;Ador;1508;804;704
46;Valencia/València;004;Agullent;2410;1191;1219
46;Valencia/València;042;Aielo de Malferit;4618;2324;2294
46;Valencia/València;043;Aielo de Rugat;155;85;70
46;Valencia/València;005;Alaquàs;29561;14527;15034
46;Valencia/València;006;Albaida;5900;2921;2979
46;Valencia/València;007;Albal;16399;8213;8186
46;Valencia/València;008;Albalat de la Ribera;3360;1689;1671
46;Valencia/València;009;Albalat dels Sorells;3977;1950;2027
46;Valencia/València;010;Albalat dels Tarongers;1232;644;588
46;Valencia/València;011;Alberic;10526;5190;5336
46;Valencia/València;012;Alborache;1160;608;552
46;Valencia/València;013;Alboraia/Alboraya;24454;11976;12478
46;Valencia/València;014;Albuixech;4017;1975;2042
46;Valencia/València;016;Alcàntera de Xúquer;1291;646;645
46;Valencia/València;015;Alcàsser;10039;5043;4996
46;Valencia/València;018;Alcublas;628;338;290
46;Valencia/València;020;Alcúdia de Crespins, l';5157;2561;2596
46;Valencia/València;019;Alcúdia, l';12009;5896;6113
46;Valencia/València;021;Aldaia;31864;15858;16006
46;Valencia/València;022;Alfafar;20890;10230;10660
46;Valencia/València;024;Alfara de la Baronia;557;272;285
46;Valencia/València;025;Alfara del Patriarca;3310;1604;1706
46;Valencia/València;026;Alfarp;1544;801;743
46;Valencia/València;027;Alfarrasí;1225;607;618
46;Valencia/València;023;Alfauir;437;223;214
46;Valencia/València;028;Algar de Palancia;481;255;226
46;Valencia/València;029;Algemesí;27331;13552;13779
46;Valencia/València;030;Algímia d'Alfara;1011;507;504
46;Valencia/València;031;Alginet;13380;6755;6625
46;Valencia/València;032;Almàssera;7349;3575;3774
46;Valencia/València;033;Almiserà;262;137;125
46;Valencia/València;034;Almoines;2414;1228;1186
46;Valencia/València;035;Almussafes;8967;4458;4509
46;Valencia/València;036;Alpuente;633;347;286
46;Valencia/València;037;Alqueria de la Comtessa, l';1476;716;760
46;Valencia/València;017;Alzira;44352;21608;22744
46;Valencia/València;038;Andilla;319;202;117
46;Valencia/València;039;Anna;2628;1322;1306
46;Valencia/València;040;Antella;1175;571;604
46;Valencia/València;041;Aras de los Olmos;381;215;166
46;Valencia/València;003;Atzeneta d'Albaida;1165;584;581
46;Valencia/València;044;Ayora;5312;2629;2683
46;Valencia/València;046;Barx;1277;672;605
46;Valencia/València;045;Barxeta;1601;825;776
46;Valencia/València;047;Bèlgida;673;330;343
46;Valencia/València;048;Bellreguard;4608;2292;2316
46;Valencia/València;049;Bellús;304;160;144
46;Valencia/València;050;Benagéber;192;110;82
46;Valencia/València;051;Benaguasil;10988;5625;5363
46;Valencia/València;052;Benavites;619;290;329
46;Valencia/València;053;Beneixida;651;323;328
46;Valencia/València;054;Benetússer;14799;7180;7619
46;Valencia/València;055;Beniarjó;1765;892;873
46;Valencia/València;056;Beniatjar;223;116;107
46;Valencia/València;057;Benicolet;569;283;286
46;Valencia/València;904;Benicull de Xúquer;1012;514;498
46;Valencia/València;060;Benifaió;11962;5928;6034
46;Valencia/València;059;Benifairó de la Valldigna;1571;780;791
46;Valencia/València;058;Benifairó de les Valls;2186;1085;1101
46;Valencia/València;061;Beniflá;457;236;221
46;Valencia/València;062;Benigànim;5841;2981;2860
46;Valencia/València;063;Benimodo;2268;1137;1131
46;Valencia/València;064;Benimuslem;653;352;301
46;Valencia/València;065;Beniparrell;1952;982;970
46;Valencia/València;066;Benirredrà;1592;779;813
46;Valencia/València;067;Benissanó;2260;1130;1130
46;Valencia/València;068;Benissoda;430;238;192
46;Valencia/València;069;Benissuera;194;95;99
46;Valencia/València;070;Bétera;24272;12101;12171
46;Valencia/València;071;Bicorp;533;262;271
46;Valencia/València;072;Bocairent;4195;2132;2063
46;Valencia/València;073;Bolbaite;1356;685;671
46;Valencia/València;074;Bonrepòs i Mirambell;3691;1815;1876
46;Valencia/València;075;Bufali;161;86;75
46;Valencia/València;076;Bugarra;727;374;353
46;Valencia/València;077;Buñol;9408;4693;4715
46;Valencia/València;078;Burjassot;38024;18332;19692
46;Valencia/València;079;Calles;355;204;151
46;Valencia/València;080;Camporrobles;1191;611;580
46;Valencia/València;081;Canals;13587;6807;6780
46;Valencia/València;082;Canet d'En Berenguer;6697;3426;3271
46;Valencia/València;083;Carcaixent;20358;10071;10287
46;Valencia/València;084;Càrcer;1862;885;977
46;Valencia/València;085;Carlet;15598;7769;7829
46;Valencia/València;086;Carrícola;94;47;47
46;Valencia/València;087;Casas Altas;131;74;57
46;Valencia/València;088;Casas Bajas;164;88;76
46;Valencia/València;089;Casinos;2777;1428;1349
46;Valencia/València;090;Castelló de Rugat;2274;1163;1111
46;Valencia/València;091;Castellonet de la Conquesta;147;80;67
46;Valencia/València;092;Castielfabib;317;168;149
46;Valencia/València;093;Catadau;2777;1378;1399
46;Valencia/València;094;Catarroja;28120;13885;14235
46;Valencia/València;095;Caudete de las Fuentes;700;370;330
46;Valencia/València;096;Cerdà;331;177;154
46;Valencia/València;107;Chella;2435;1205;1230
46;Valencia/València;106;Chelva;1489;766;723
46;Valencia/València;108;Chera;474;256;218
46;Valencia/València;109;Cheste;8494;4339;4155
46;Valencia/València;111;Chiva;15123;7740;7383
46;Valencia/València;112;Chulilla;665;355;310
46;Valencia/València;097;Cofrentes;1130;574;556
46;Valencia/València;098;Corbera;3100;1547;1553
46;Valencia/València;099;Cortes de Pallás;814;447;367
46;Valencia/València;100;Cotes;333;171;162
46;Valencia/València;105;Cullera;22145;11037;11108
46;Valencia/València;113;Daimús;3117;1538;1579
46;Valencia/València;114;Domeño;708;357;351
46;Valencia/València;115;Dos Aguas;376;209;167
46;Valencia/València;116;Eliana, l';18235;8875;9360
46;Valencia/València;117;Emperador;687;359;328
46;Valencia/València;118;Enguera;4752;2366;2386
46;Valencia/València;119;Ènova, l';887;453;434
46;Valencia/València;120;Estivella;1456;703;753
46;Valencia/València;121;Estubeny;121;61;60
46;Valencia/València;122;Faura;3538;1791;1747
46;Valencia/València;123;Favara;2518;1286;1232
46;Valencia/València;126;Foios;7367;3632;3735
46;Valencia/València;128;Font de la Figuera, la;2038;1020;1018
46;Valencia/València;127;Font d'En Carròs, la;3794;1889;1905
46;Valencia/València;124;Fontanars dels Alforins;971;500;471
46;Valencia/València;125;Fortaleny;1026;508;518
46;Valencia/València;129;Fuenterrobles;682;379;303
46;Valencia/València;131;Gandia;74562;36665;37897
46;Valencia/València;902;Gátova;378;180;198
46;Valencia/València;130;Gavarda;1038;498;540
46;Valencia/València;132;Genovés, el;2842;1428;1414
46;Valencia/València;133;Gestalgar;556;295;261
46;Valencia/València;134;Gilet;3324;1719;1605
46;Valencia/València;135;Godella;13088;6317;6771
46;Valencia/València;136;Godelleta;3533;1819;1714
46;Valencia/València;137;Granja de la Costera, la;285;142;143
46;Valencia/València;138;Guadasséquies;468;239;229
46;Valencia/València;139;Guadassuar;5893;2882;3011
46;Valencia/València;140;Guardamar de la Safor;526;283;243
46;Valencia/València;141;Higueruelas;500;271;229
46;Valencia/València;142;Jalance;830;425;405
46;Valencia/València;144;Jarafuel;754;394;360
46;Valencia/València;154;Llanera de Ranes;1055;529;526
46;Valencia/València;155;Llaurí;1170;607;563
46;Valencia/València;147;Llíria;23253;11767;11486
46;Valencia/València;152;Llocnou de la Corona;118;64;54
46;Valencia/València;153;Llocnou de Sant Jeroni;546;276;270
46;Valencia/València;151;Llocnou d'En Fenollet;916;476;440
46;Valencia/València;156;Llombai;2685;1351;1334
46;Valencia/València;157;Llosa de Ranes, la;3575;1833;1742
46;Valencia/València;150;Llutxent;2345;1200;1145
46;Valencia/València;148;Loriguilla;2025;1036;989
46;Valencia/València;149;Losa del Obispo;507;261;246
46;Valencia/València;158;Macastre;1283;681;602
46;Valencia/València;159;Manises;30919;15266;15653
46;Valencia/València;160;Manuel;2428;1196;1232
46;Valencia/València;161;Marines;1828;966;862
46;Valencia/València;162;Massalavés;1596;843;753
46;Valencia/València;163;Massalfassar;2469;1230;1239
46;Valencia/València;164;Massamagrell;15952;7889;8063
46;Valencia/València;165;Massanassa;9667;4794;4873
46;Valencia/València;166;Meliana;10822;5309;5513
46;Valencia/València;167;Millares;345;183;162
46;Valencia/València;168;Miramar;2634;1355;1279
46;Valencia/València;169;Mislata;43691;21246;22445
46;Valencia/València;170;Mogente/Moixent;4302;2155;2147
46;Valencia/València;171;Moncada;21935;10706;11229
46;Valencia/València;173;Montaverner;1630;809;821
46;Valencia/València;174;Montesa;1164;585;579
46;Valencia/València;175;Montitxelvo/Montichelvo;584;289;295
46;Valencia/València;176;Montroi/Montroy;2867;1533;1334
46;Valencia/València;172;Montserrat;7878;4053;3825
46;Valencia/València;177;Museros;6458;3253;3205
46;Valencia/València;178;Nàquera/Náquera;6577;3410;3167
46;Valencia/València;179;Navarrés;2968;1503;1465
46;Valencia/València;180;Novelé/Novetlè;837;411;426
46;Valencia/València;181;Oliva;25101;12312;12789
46;Valencia/València;183;Olleria, l';8281;4132;4149
46;Valencia/València;182;Olocau;1771;931;840
46;Valencia/València;184;Ontinyent;35347;17441;17906
46;Valencia/València;185;Otos;434;219;215
46;Valencia/València;186;Paiporta;26088;12884;13204
46;Valencia/València;187;Palma de Gandía;1631;843;788
46;Valencia/València;188;Palmera;1024;523;501
46;Valencia/València;189;Palomar, el;590;297;293
46;Valencia/València;190;Paterna;70195;34697;35498
46;Valencia/València;191;Pedralba;2778;1453;1325
46;Valencia/València;192;Petrés;997;504;493
46;Valencia/València;193;Picanya;11513;5709;5804
46;Valencia/València;194;Picassent;20942;10540;10402
46;Valencia/València;195;Piles;2685;1346;1339
46;Valencia/València;196;Pinet;157;76;81
46;Valencia/València;199;Pobla de Farnals, la;7978;4038;3940
46;Valencia/València;202;Pobla de Vallbona, la;24433;12312;12121
46;Valencia/València;200;Pobla del Duc, la;2543;1238;1305
46;Valencia/València;203;Pobla Llarga, la;4452;2242;2210
46;Valencia/València;197;Polinyà de Xúquer;2472;1250;1222
46;Valencia/València;198;Potries;1046;528;518
46;Valencia/València;205;Puçol;19495;9590;9905
46;Valencia/València;201;Puebla de San Miguel;62;39;23
46;Valencia/València;204;Puig de Santa Maria, el;8630;4216;4414
46;Valencia/València;101;Quart de les Valls;988;470;518
46;Valencia/València;102;Quart de Poblet;24760;12053;12707
46;Valencia/València;103;Quartell;1636;784;852
46;Valencia/València;104;Quatretonda;2212;1108;1104
46;Valencia/València;206;Quesa;670;348;322
46;Valencia/València;207;Rafelbunyol;8941;4390;4551
46;Valencia/València;208;Rafelcofer;1345;659;686
46;Valencia/València;209;Rafelguaraf;2335;1156;1179
46;Valencia/València;210;Ráfol de Salem;462;224;238
46;Valencia/València;212;Real;2154;1103;1051
46;Valencia/València;211;Real de Gandia, el;2461;1204;1257
46;Valencia/València;213;Requena;20254;10129;10125
46;Valencia/València;214;Riba-roja de Túria;22264;11271;10993
46;Valencia/València;215;Riola;1759;884;875
46;Valencia/València;216;Rocafort;7240;3537;3703
46;Valencia/València;217;Rotglà i Corberà;1138;572;566
46;Valencia/València;218;Rótova;1294;677;617
46;Valencia/València;219;Rugat;158;83;75
46;Valencia/València;220;Sagunto/Sagunt;66140;32366;33774
46;Valencia/València;221;Salem;424;218;206
46;Valencia/València;903;San Antonio de Benagéber;9089;4477;4612
46;Valencia/València;222;Sant Joanet;504;250;254
46;Valencia/València;223;Sedaví;10333;5040;5293
46;Valencia/València;224;Segart;163;84;79
46;Valencia/València;225;Sellent;389;191;198
46;Valencia/València;226;Sempere;34;19;15
46;Valencia/València;227;Senyera;1136;563;573
46;Valencia/València;228;Serra;3124;1618;1506
46;Valencia/València;229;Siete Aguas;1154;611;543
46;Valencia/València;230;Silla;18771;9325;9446
46;Valencia/València;231;Simat de la Valldigna;3329;1658;1671
46;Valencia/València;232;Sinarcas;1125;581;544
46;Valencia/València;233;Sollana;4861;2376;2485
46;Valencia/València;234;Sot de Chera;369;202;167
46;Valencia/València;235;Sueca;27479;13548;13931
46;Valencia/València;236;Sumacàrcer;1096;540;556
46;Valencia/València;237;Tavernes Blanques;9120;4463;4657
46;Valencia/València;238;Tavernes de la Valldigna;17201;8571;8630
46;Valencia/València;239;Teresa de Cofrentes;636;329;307
46;Valencia/València;240;Terrateig;278;147;131
46;Valencia/València;241;Titaguas;453;238;215
46;Valencia/València;242;Torrebaja;411;222;189
46;Valencia/València;243;Torrella;146;81;65
46;Valencia/València;244;Torrent;82208;40482;41726
46;Valencia/València;245;Torres Torres;637;342;295
46;Valencia/València;246;Tous;1263;638;625
46;Valencia/València;247;Tuéjar;1116;591;525
46;Valencia/València;248;Turís;6646;3480;3166
46;Valencia/València;249;Utiel;11531;5763;5768
46;Valencia/València;250;València;794288;377504;416784
46;Valencia/València;251;Vallada;3039;1544;1495
46;Valencia/València;252;Vallanca;139;76;63
46;Valencia/València;253;Vallés;157;84;73
46;Valencia/València;254;Venta del Moro;1207;644;563
46;Valencia/València;255;Vilallonga/Villalonga;4270;2076;2194
46;Valencia/València;256;Vilamarxant;9717;5024;4693
46;Valencia/València;257;Villanueva de Castellón;7049;3474;3575
46;Valencia/València;258;Villar del Arzobispo;3554;1803;1751
46;Valencia/València;259;Villargordo del Cabriel;589;304;285
46;Valencia/València;260;Vinalesa;3420;1657;1763
46;Valencia/València;145;Xàtiva;29231;14288;14943
46;Valencia/València;143;Xeraco;5655;2853;2802
46;Valencia/València;146;Xeresa;2168;1109;1059
46;Valencia/València;110;Xirivella;29623;14658;14965
46;Valencia/València;261;Yátova;2067;1068;999
46;Valencia/València;262;Yesa, La;229;122;107
46;Valencia/València;263;Zarra;359;200;159
47;Valladolid;001;Adalia;53;33;20
47;Valladolid;002;Aguasal;19;12;7
47;Valladolid;003;Aguilar de Campos;243;140;103
47;Valladolid;004;Alaejos;1369;732;637
47;Valladolid;005;Alcazarén;635;343;292
47;Valladolid;006;Aldea de San Miguel;224;123;101
47;Valladolid;007;Aldeamayor de San Martín;5524;2859;2665
47;Valladolid;008;Almenara de Adaja;22;11;11
47;Valladolid;009;Amusquillo;103;65;38
47;Valladolid;010;Arroyo de la Encomienda;20179;10171;10008
47;Valladolid;011;Ataquines;583;318;265
47;Valladolid;012;Bahabón;108;50;58
47;Valladolid;013;Barcial de la Loma;92;52;40
47;Valladolid;014;Barruelo del Valle;52;33;19
47;Valladolid;015;Becilla de Valderaduey;238;136;102
47;Valladolid;016;Benafarces;72;35;37
47;Valladolid;017;Bercero;207;112;95
47;Valladolid;018;Berceruelo;36;22;14
47;Valladolid;019;Berrueces;109;62;47
47;Valladolid;020;Bobadilla del Campo;293;163;130
47;Valladolid;021;Bocigas;80;45;35
47;Valladolid;022;Bocos de Duero;75;38;37
47;Valladolid;023;Boecillo;4206;2143;2063
47;Valladolid;024;Bolaños de Campos;291;160;131
47;Valladolid;025;Brahojos de Medina;117;61;56
47;Valladolid;026;Bustillo de Chaves;69;43;26
47;Valladolid;027;Cabezón de Pisuerga;3713;1893;1820
47;Valladolid;028;Cabezón de Valderaduey;33;19;14
47;Valladolid;029;Cabreros del Monte;62;36;26
47;Valladolid;030;Campaspero;1079;600;479
47;Valladolid;031;Campillo, El;222;133;89
47;Valladolid;032;Camporredondo;157;89;68
47;Valladolid;033;Canalejas de Peñafiel;231;128;103
47;Valladolid;034;Canillas de Esgueva;75;44;31
47;Valladolid;035;Carpio;1016;545;471
47;Valladolid;036;Casasola de Arión;249;136;113
47;Valladolid;037;Castrejón de Trabancos;174;85;89
47;Valladolid;038;Castrillo de Duero;111;66;45
47;Valladolid;039;Castrillo-Tejeriego;171;96;75
47;Valladolid;040;Castrobol;61;32;29
47;Valladolid;041;Castrodeza;160;98;62
47;Valladolid;042;Castromembibre;54;38;16
47;Valladolid;043;Castromonte;320;175;145
47;Valladolid;044;Castronuevo de Esgueva;369;197;172
47;Valladolid;045;Castronuño;828;418;410
47;Valladolid;046;Castroponce;143;78;65
47;Valladolid;047;Castroverde de Cerrato;221;139;82
47;Valladolid;048;Ceinos de Campos;211;116;95
47;Valladolid;049;Cervillego de la Cruz;90;52;38
47;Valladolid;050;Cigales;5235;2662;2573
47;Valladolid;051;Ciguñuela;369;194;175
47;Valladolid;052;Cistérniga;9034;4569;4465
47;Valladolid;053;Cogeces de Íscar;141;69;72
47;Valladolid;054;Cogeces del Monte;685;370;315
47;Valladolid;055;Corcos;201;111;90
47;Valladolid;056;Corrales de Duero;105;60;45
47;Valladolid;057;Cubillas de Santa Marta;326;191;135
47;Valladolid;058;Cuenca de Campos;224;115;109
47;Valladolid;059;Curiel de Duero;123;77;46
47;Valladolid;060;Encinas de Esgueva;248;147;101
47;Valladolid;061;Esguevillas de Esgueva;271;146;125
47;Valladolid;062;Fombellida;173;100;73
47;Valladolid;063;Fompedraza;99;51;48
47;Valladolid;064;Fontihoyuelo;38;22;16
47;Valladolid;065;Fresno el Viejo;885;472;413
47;Valladolid;066;Fuensaldaña;1773;909;864
47;Valladolid;067;Fuente el Sol;156;82;74
47;Valladolid;068;Fuente-Olmedo;34;17;17
47;Valladolid;069;Gallegos de Hornija;122;63;59
47;Valladolid;070;Gatón de Campos;33;17;16
47;Valladolid;071;Geria;509;242;267
47;Valladolid;073;Herrín de Campos;122;60;62
47;Valladolid;074;Hornillos de Eresma;165;97;68
47;Valladolid;075;Íscar;6344;3201;3143
47;Valladolid;076;Laguna de Duero;22725;11315;11410
47;Valladolid;077;Langayo;248;156;92
47;Valladolid;079;Llano de Olmedo;59;32;27
47;Valladolid;078;Lomoviejo;176;94;82
47;Valladolid;080;Manzanillo;52;26;26
47;Valladolid;081;Marzales;45;22;23
47;Valladolid;082;Matapozuelos;1058;539;519
47;Valladolid;083;Matilla de los Caños;102;60;42
47;Valladolid;084;Mayorga;1509;748;761
47;Valladolid;086;Medina de Rioseco;4647;2286;2361
47;Valladolid;085;Medina del Campo;20510;9958;10552
47;Valladolid;087;Megeces;430;230;200
47;Valladolid;088;Melgar de Abajo;112;61;51
47;Valladolid;089;Melgar de Arriba;147;82;65
47;Valladolid;090;Mojados;3210;1680;1530
47;Valladolid;091;Monasterio de Vega;77;41;36
47;Valladolid;092;Montealegre de Campos;109;66;43
47;Valladolid;093;Montemayor de Pililla;868;472;396
47;Valladolid;094;Moral de la Reina;148;85;63
47;Valladolid;095;Moraleja de las Panaderas;42;23;19
47;Valladolid;096;Morales de Campos;138;72;66
47;Valladolid;097;Mota del Marqués;351;186;165
47;Valladolid;098;Mucientes;662;336;326
47;Valladolid;099;Mudarra, La;158;80;78
47;Valladolid;100;Muriel;123;65;58
47;Valladolid;101;Nava del Rey;1986;1018;968
47;Valladolid;102;Nueva Villa de las Torres;280;162;118
47;Valladolid;103;Olivares de Duero;296;162;134
47;Valladolid;104;Olmedo;3643;1806;1837
47;Valladolid;105;Olmos de Esgueva;201;111;90
47;Valladolid;106;Olmos de Peñafiel;52;28;24
47;Valladolid;109;Palazuelo de Vedija;191;102;89
47;Valladolid;110;Parrilla, La;480;241;239
47;Valladolid;111;Pedraja de Portillo, La;1139;587;552
47;Valladolid;112;Pedrajas de San Esteban;3327;1703;1624
47;Valladolid;113;Pedrosa del Rey;168;96;72
47;Valladolid;114;Peñafiel;5037;2522;2515
47;Valladolid;115;Peñaflor de Hornija;297;170;127
47;Valladolid;116;Pesquera de Duero;448;243;205
47;Valladolid;117;Piña de Esgueva;324;170;154
47;Valladolid;118;Piñel de Abajo;161;91;70
47;Valladolid;119;Piñel de Arriba;89;48;41
47;Valladolid;121;Pollos;597;317;280
47;Valladolid;122;Portillo;2432;1270;1162
47;Valladolid;123;Pozal de Gallinas;539;300;239
47;Valladolid;124;Pozaldez;482;255;227
47;Valladolid;125;Pozuelo de la Orden;49;29;20
47;Valladolid;126;Puras;46;26;20
47;Valladolid;127;Quintanilla de Arriba;163;92;71
47;Valladolid;129;Quintanilla de Onésimo;1028;543;485
47;Valladolid;130;Quintanilla de Trigueros;108;54;54
47;Valladolid;128;Quintanilla del Molar;65;31;34
47;Valladolid;131;Rábano;177;92;85
47;Valladolid;132;Ramiro;43;24;19
47;Valladolid;133;Renedo de Esgueva;3788;1941;1847
47;Valladolid;134;Roales de Campos;157;88;69
47;Valladolid;135;Robladillo;92;54;38
47;Valladolid;137;Roturas;33;20;13
47;Valladolid;138;Rubí de Bracamonte;228;129;99
47;Valladolid;139;Rueda;1254;645;609
47;Valladolid;140;Saelices de Mayorga;113;70;43
47;Valladolid;141;Salvador de Zapardiel;120;71;49
47;Valladolid;142;San Cebrián de Mazote;135;82;53
47;Valladolid;143;San Llorente;113;62;51
47;Valladolid;144;San Martín de Valvení;83;45;38
47;Valladolid;145;San Miguel del Arroyo;668;355;313
47;Valladolid;146;San Miguel del Pino;350;180;170
47;Valladolid;147;San Pablo de la Moraleja;109;61;48
47;Valladolid;148;San Pedro de Latarce;483;258;225
47;Valladolid;149;San Pelayo;49;25;24
47;Valladolid;150;San Román de Hornija;312;151;161
47;Valladolid;151;San Salvador;26;15;11
47;Valladolid;156;San Vicente del Palacio;161;85;76
47;Valladolid;152;Santa Eufemia del Arroyo;75;42;33
47;Valladolid;153;Santervás de Campos;118;61;57
47;Valladolid;154;Santibáñez de Valcorba;164;92;72
47;Valladolid;155;Santovenia de Pisuerga;4480;2310;2170
47;Valladolid;157;Sardón de Duero;580;313;267
47;Valladolid;158;Seca, La;1077;548;529
47;Valladolid;159;Serrada;1136;593;543
47;Valladolid;160;Siete Iglesias de Trabancos;428;229;199
47;Valladolid;161;Simancas;5276;2678;2598
47;Valladolid;162;Tamariz de Campos;80;45;35
47;Valladolid;163;Tiedra;288;139;149
47;Valladolid;164;Tordehumos;417;224;193
47;Valladolid;165;Tordesillas;8750;4417;4333
47;Valladolid;169;Torre de Esgueva;65;33;32
47;Valladolid;170;Torre de Peñafiel;48;29;19
47;Valladolid;166;Torrecilla de la Abadesa;273;134;139
47;Valladolid;167;Torrecilla de la Orden;253;128;125
47;Valladolid;168;Torrecilla de la Torre;35;22;13
47;Valladolid;171;Torrelobatón;408;216;192
47;Valladolid;172;Torrescárcela;154;81;73
47;Valladolid;173;Traspinedo;1109;592;517
47;Valladolid;174;Trigueros del Valle;314;172;142
47;Valladolid;175;Tudela de Duero;8564;4366;4198
47;Valladolid;176;Unión de Campos, La;228;117;111
47;Valladolid;177;Urones de Castroponce;110;64;46
47;Valladolid;178;Urueña;182;102;80
47;Valladolid;179;Valbuena de Duero;468;252;216
47;Valladolid;180;Valdearcos de la Vega;57;31;26
47;Valladolid;181;Valdenebro de los Valles;192;102;90
47;Valladolid;182;Valdestillas;1643;851;792
47;Valladolid;183;Valdunquillo;147;72;75
47;Valladolid;186;Valladolid;298412;140059;158353
47;Valladolid;184;Valoria la Buena;629;339;290
47;Valladolid;185;Valverde de Campos;95;56;39
47;Valladolid;187;Vega de Ruiponce;90;53;37
47;Valladolid;188;Vega de Valdetronco;118;64;54
47;Valladolid;189;Velascálvaro;163;90;73
47;Valladolid;190;Velilla;110;54;56
47;Valladolid;191;Velliza;118;74;44
47;Valladolid;192;Ventosa de la Cuesta;103;61;42
47;Valladolid;193;Viana de Cega;2032;1054;978
47;Valladolid;195;Villabáñez;490;269;221
47;Valladolid;196;Villabaruz de Campos;29;15;14
47;Valladolid;197;Villabrágima;1036;547;489
47;Valladolid;198;Villacarralón;79;47;32
47;Valladolid;199;Villacid de Campos;70;45;25
47;Valladolid;200;Villaco;76;51;25
47;Valladolid;203;Villafrades de Campos;66;37;29
47;Valladolid;204;Villafranca de Duero;258;135;123
47;Valladolid;205;Villafrechós;490;266;224
47;Valladolid;206;Villafuerte;80;45;35
47;Valladolid;207;Villagarcía de Campos;307;184;123
47;Valladolid;208;Villagómez la Nueva;68;35;33
47;Valladolid;209;Villalán de Campos;33;21;12
47;Valladolid;210;Villalar de los Comuneros;468;225;243
47;Valladolid;211;Villalba de la Loma;55;30;25
47;Valladolid;212;Villalba de los Alcores;379;206;173
47;Valladolid;213;Villalbarba;121;60;61
47;Valladolid;214;Villalón de Campos;1602;791;811
47;Valladolid;215;Villamuriel de Campos;52;27;25
47;Valladolid;216;Villán de Tordesillas;127;75;52
47;Valladolid;217;Villanubla;2713;1401;1312
47;Valladolid;218;Villanueva de Duero;1184;619;565
47;Valladolid;219;Villanueva de la Condesa;61;34;27
47;Valladolid;220;Villanueva de los Caballeros;175;93;82
47;Valladolid;221;Villanueva de los Infantes;102;62;40
47;Valladolid;222;Villanueva de San Mancio;87;48;39
47;Valladolid;223;Villardefrades;170;96;74
47;Valladolid;224;Villarmentero de Esgueva;111;61;50
47;Valladolid;225;Villasexmir;75;42;33
47;Valladolid;226;Villavaquerín;159;91;68
47;Valladolid;227;Villavellid;57;37;20
47;Valladolid;228;Villaverde de Medina;533;289;244
47;Valladolid;229;Villavicencio de los Caballeros;245;116;129
47;Valladolid;194;Viloria;340;177;163
47;Valladolid;230;Wamba;323;172;151
47;Valladolid;231;Zaratán;6233;3184;3049
47;Valladolid;232;Zarza, La;111;60;51
49;Zamora;002;Abezames;61;30;31
49;Zamora;003;Alcañices;1076;560;516
49;Zamora;004;Alcubilla de Nogales;117;64;53
49;Zamora;005;Alfaraz de Sayago;129;74;55
49;Zamora;006;Algodre;148;78;70
49;Zamora;007;Almaraz de Duero;407;210;197
49;Zamora;008;Almeida de Sayago;452;240;212
49;Zamora;009;Andavías;444;227;217
49;Zamora;010;Arcenillas;420;214;206
49;Zamora;011;Arcos de la Polvorosa;221;122;99
49;Zamora;012;Argañín;80;40;40
49;Zamora;013;Argujillo;242;122;120
49;Zamora;014;Arquillinos;117;59;58
49;Zamora;015;Arrabalde;216;107;109
49;Zamora;016;Aspariegos;247;115;132
49;Zamora;017;Asturianos;271;137;134
49;Zamora;018;Ayoó de Vidriales;308;157;151
49;Zamora;019;Barcial del Barco;249;132;117
49;Zamora;020;Belver de los Montes;275;151;124
49;Zamora;021;Benavente;17935;8683;9252
49;Zamora;022;Benegiles;305;162;143
49;Zamora;023;Bermillo de Sayago;1015;540;475
49;Zamora;024;Bóveda de Toro, La;709;357;352
49;Zamora;025;Bretó;166;97;69
49;Zamora;026;Bretocino;213;115;98
49;Zamora;027;Brime de Sog;130;62;68
49;Zamora;028;Brime de Urz;104;62;42
49;Zamora;029;Burganes de Valverde;663;348;315
49;Zamora;030;Bustillo del Oro;84;44;40
49;Zamora;031;Cabañas de Sayago;151;80;71
49;Zamora;032;Calzadilla de Tera;300;144;156
49;Zamora;033;Camarzana de Tera;776;386;390
49;Zamora;034;Cañizal;456;236;220
49;Zamora;035;Cañizo;233;129;104
49;Zamora;036;Carbajales de Alba;525;266;259
49;Zamora;037;Carbellino;189;102;87
49;Zamora;038;Casaseca de Campeán;99;58;41
49;Zamora;039;Casaseca de las Chanas;390;205;185
49;Zamora;040;Castrillo de la Guareña;125;65;60
49;Zamora;041;Castrogonzalo;471;257;214
49;Zamora;042;Castronuevo;228;112;116
49;Zamora;043;Castroverde de Campos;287;150;137
49;Zamora;044;Cazurra;79;42;37
49;Zamora;046;Cerecinos de Campos;259;143;116
49;Zamora;047;Cerecinos del Carrizal;112;65;47
49;Zamora;048;Cernadilla;114;60;54
49;Zamora;050;Cobreros;579;313;266
49;Zamora;052;Coomonte;187;102;85
49;Zamora;053;Coreses;1047;543;504
49;Zamora;054;Corrales del Vino;961;474;487
49;Zamora;055;Cotanes del Monte;103;57;46
49;Zamora;056;Cubillos;313;154;159
49;Zamora;057;Cubo de Benavente;114;63;51
49;Zamora;058;Cubo de Tierra del Vino, El;320;168;152
49;Zamora;059;Cuelgamures;85;53;32
49;Zamora;061;Entrala;156;85;71
49;Zamora;062;Espadañedo;107;53;54
49;Zamora;063;Faramontanos de Tábara;330;173;157
49;Zamora;064;Fariza;506;264;242
49;Zamora;065;Fermoselle;1206;608;598
49;Zamora;066;Ferreras de Abajo;499;252;247
49;Zamora;067;Ferreras de Arriba;365;203;162
49;Zamora;068;Ferreruela;466;257;209
49;Zamora;069;Figueruela de Arriba;332;157;175
49;Zamora;071;Fonfría;756;397;359
49;Zamora;075;Fresno de la Polvorosa;138;76;62
49;Zamora;076;Fresno de la Ribera;377;195;182
49;Zamora;077;Fresno de Sayago;167;86;81
49;Zamora;078;Friera de Valverde;152;83;69
49;Zamora;079;Fuente Encalada;106;59;47
49;Zamora;080;Fuentelapeña;684;359;325
49;Zamora;082;Fuentes de Ropel;374;192;182
49;Zamora;081;Fuentesaúco;1475;733;742
49;Zamora;083;Fuentesecas;50;25;25
49;Zamora;084;Fuentespreadas;286;153;133
49;Zamora;085;Galende;1004;507;497
49;Zamora;086;Gallegos del Pan;113;66;47
49;Zamora;087;Gallegos del Río;490;272;218
49;Zamora;088;Gamones;93;55;38
49;Zamora;090;Gema;217;107;110
49;Zamora;091;Granja de Moreruela;277;142;135
49;Zamora;092;Granucillo;122;60;62
49;Zamora;093;Guarrate;327;168;159
49;Zamora;094;Hermisende;228;118;110
49;Zamora;095;Hiniesta, La;316;166;150
49;Zamora;096;Jambrina;159;84;75
49;Zamora;097;Justel;75;46;29
49;Zamora;098;Losacino;215;121;94
49;Zamora;099;Losacio;101;56;45
49;Zamora;100;Lubián;307;160;147
49;Zamora;101;Luelmo;154;84;70
49;Zamora;102;Maderal, El;187;100;87
49;Zamora;103;Madridanos;458;241;217
49;Zamora;104;Mahide;336;190;146
49;Zamora;105;Maire de Castroponce;146;75;71
49;Zamora;107;Malva;123;55;68
49;Zamora;108;Manganeses de la Lampreana;478;239;239
49;Zamora;109;Manganeses de la Polvorosa;633;309;324
49;Zamora;110;Manzanal de Arriba;364;190;174
49;Zamora;112;Manzanal de los Infantes;123;68;55
49;Zamora;111;Manzanal del Barco;126;66;60
49;Zamora;113;Matilla de Arzón;169;98;71
49;Zamora;114;Matilla la Seca;42;24;18
49;Zamora;115;Mayalde;182;99;83
49;Zamora;116;Melgar de Tera;373;193;180
49;Zamora;117;Micereces de Tera;457;233;224
49;Zamora;118;Milles de la Polvorosa;215;116;99
49;Zamora;119;Molacillos;257;139;118
49;Zamora;120;Molezuelas de la Carballeda;56;31;25
49;Zamora;121;Mombuey;407;221;186
49;Zamora;122;Monfarracinos;967;504;463
49;Zamora;123;Montamarta;593;308;285
49;Zamora;124;Moral de Sayago;257;145;112
49;Zamora;126;Moraleja de Sayago;284;146;138
49;Zamora;125;Moraleja del Vino;1721;872;849
49;Zamora;128;Morales de Rey;577;290;287
49;Zamora;129;Morales de Toro;976;513;463
49;Zamora;130;Morales de Valverde;162;82;80
49;Zamora;127;Morales del Vino;2947;1537;1410
49;Zamora;131;Moralina;248;128;120
49;Zamora;132;Moreruela de los Infanzones;341;180;161
49;Zamora;133;Moreruela de Tábara;315;169;146
49;Zamora;134;Muelas de los Caballeros;172;96;76
49;Zamora;135;Muelas del Pan;634;329;305
49;Zamora;136;Muga de Sayago;353;172;181
49;Zamora;137;Navianos de Valverde;182;104;78
49;Zamora;138;Olmillos de Castro;219;118;101
49;Zamora;139;Otero de Bodas;155;85;70
49;Zamora;141;Pajares de la Lampreana;315;159;156
49;Zamora;143;Palacios de Sanabria;225;112;113
49;Zamora;142;Palacios del Pan;261;134;127
49;Zamora;145;Pedralba de la Pradería;237;131;106
49;Zamora;146;Pego, El;296;150;146
49;Zamora;147;Peleagonzalo;266;135;131
49;Zamora;148;Peleas de Abajo;283;132;151
49;Zamora;149;Peñausende;385;194;191
49;Zamora;150;Peque;130;56;74
49;Zamora;151;Perdigón, El;671;354;317
49;Zamora;152;Pereruela;530;285;245
49;Zamora;153;Perilla de Castro;161;83;78
49;Zamora;154;Pías;113;65;48
49;Zamora;155;Piedrahita de Castro;87;47;40
49;Zamora;156;Pinilla de Toro;232;125;107
49;Zamora;157;Pino del Oro;195;105;90
49;Zamora;158;Piñero, El;227;118;109
49;Zamora;160;Pobladura de Valderaduey;40;22;18
49;Zamora;159;Pobladura del Valle;295;156;139
49;Zamora;162;Porto;178;99;79
49;Zamora;163;Pozoantiguo;224;114;110
49;Zamora;164;Pozuelo de Tábara;163;80;83
49;Zamora;165;Prado;53;30;23
49;Zamora;166;Puebla de Sanabria;1373;670;703
49;Zamora;167;Pueblica de Valverde;184;101;83
49;Zamora;170;Quintanilla de Urz;101;53;48
49;Zamora;168;Quintanilla del Monte;103;58;45
49;Zamora;169;Quintanilla del Olmo;32;16;16
49;Zamora;171;Quiruelas de Vidriales;656;343;313
49;Zamora;172;Rabanales;521;272;249
49;Zamora;173;Rábano de Aliste;369;184;185
49;Zamora;174;Requejo;156;74;82
49;Zamora;175;Revellinos;249;131;118
49;Zamora;176;Riofrío de Aliste;646;360;286
49;Zamora;177;Rionegro del Puente;278;148;130
49;Zamora;178;Roales;931;493;438
49;Zamora;179;Robleda-Cervantes;405;223;182
49;Zamora;180;Roelos de Sayago;149;73;76
49;Zamora;181;Rosinos de la Requejada;357;195;162
49;Zamora;183;Salce;96;43;53
49;Zamora;184;Samir de los Caños;174;100;74
49;Zamora;185;San Agustín del Pozo;183;95;88
49;Zamora;186;San Cebrián de Castro;239;117;122
49;Zamora;187;San Cristóbal de Entreviñas;1385;724;661
49;Zamora;188;San Esteban del Molar;128;74;54
49;Zamora;189;San Justo;208;113;95
49;Zamora;190;San Martín de Valderaduey;53;27;26
49;Zamora;191;San Miguel de la Ribera;291;143;148
49;Zamora;192;San Miguel del Valle;140;69;71
49;Zamora;193;San Pedro de Ceque;449;233;216
49;Zamora;194;San Pedro de la Nave-Almendra;347;178;169
49;Zamora;208;San Vicente de la Cabeza;378;200;178
49;Zamora;209;San Vitero;516;287;229
49;Zamora;197;Santa Clara de Avedillo;168;83;85
49;Zamora;199;Santa Colomba de las Monjas;261;127;134
49;Zamora;200;Santa Cristina de la Polvorosa;1069;545;524
49;Zamora;201;Santa Croya de Tera;299;152;147
49;Zamora;202;Santa Eufemia del Barco;177;102;75
49;Zamora;203;Santa María de la Vega;311;162;149
49;Zamora;204;Santa María de Valverde;56;28;28
49;Zamora;205;Santibáñez de Tera;383;191;192
49;Zamora;206;Santibáñez de Vidriales;958;485;473
49;Zamora;207;Santovenia;241;118;123
49;Zamora;210;Sanzoles;492;249;243
49;Zamora;214;Tábara;747;383;364
49;Zamora;216;Tapioles;150;88;62
49;Zamora;219;Toro;8713;4278;4435
49;Zamora;220;Torre del Valle, La;144;77;67
49;Zamora;221;Torregamones;258;134;124
49;Zamora;222;Torres del Carrizal;410;209;201
49;Zamora;223;Trabazos;878;467;411
49;Zamora;224;Trefacio;189;99;90
49;Zamora;225;Uña de Quintana;133;72;61
49;Zamora;226;Vadillo de la Guareña;248;132;116
49;Zamora;227;Valcabado;372;191;181
49;Zamora;228;Valdefinjas;55;33;22
49;Zamora;229;Valdescorriel;125;61;64
49;Zamora;230;Vallesa de la Guareña;83;45;38
49;Zamora;231;Vega de Tera;328;156;172
49;Zamora;232;Vega de Villalobos;99;44;55
49;Zamora;233;Vegalatrave;88;45;43
49;Zamora;234;Venialbo;443;242;201
49;Zamora;235;Vezdemarbán;449;230;219
49;Zamora;236;Vidayanes;85;45;40
49;Zamora;237;Videmala;147;76;71
49;Zamora;238;Villabrázaro;252;130;122
49;Zamora;239;Villabuena del Puente;675;343;332
49;Zamora;240;Villadepera;198;107;91
49;Zamora;241;Villaescusa;249;136;113
49;Zamora;242;Villafáfila;478;249;229
49;Zamora;243;Villaferrueña;110;56;54
49;Zamora;244;Villageriz;56;34;22
49;Zamora;245;Villalazán;267;132;135
49;Zamora;246;Villalba de la Lampreana;227;126;101
49;Zamora;247;Villalcampo;432;212;220
49;Zamora;248;Villalobos;239;117;122
49;Zamora;249;Villalonso;81;46;35
49;Zamora;250;Villalpando;1475;720;755
49;Zamora;251;Villalube;169;90;79
49;Zamora;252;Villamayor de Campos;333;167;166
49;Zamora;255;Villamor de los Escuderos;384;203;181
49;Zamora;256;Villanázar;274;143;131
49;Zamora;257;Villanueva de Azoague;350;177;173
49;Zamora;258;Villanueva de Campeán;112;63;49
49;Zamora;259;Villanueva de las Peras;78;38;40
49;Zamora;260;Villanueva del Campo;818;403;415
49;Zamora;263;Villar de Fallaves;45;25;20
49;Zamora;264;Villar del Buey;571;296;275
49;Zamora;261;Villaralbo;1821;919;902
49;Zamora;262;Villardeciervos;413;207;206
49;Zamora;265;Villardiegua de la Ribera;127;68;59
49;Zamora;266;Villárdiga;77;44;33
49;Zamora;267;Villardondiego;107;60;47
49;Zamora;268;Villarrín de Campos;383;206;177
49;Zamora;269;Villaseco del Pan;231;108;123
49;Zamora;270;Villavendimio;162;100;62
49;Zamora;272;Villaveza de Valverde;77;39;38
49;Zamora;271;Villaveza del Agua;187;103;84
49;Zamora;273;Viñas;180;95;85
49;Zamora;275;Zamora;61406;28524;32882
50;Zaragoza;001;Abanto;100;59;41
50;Zaragoza;002;Acered;166;98;68
50;Zaragoza;003;Agón;137;80;57
50;Zaragoza;004;Aguarón;636;337;299
50;Zaragoza;005;Aguilón;251;136;115
50;Zaragoza;006;Ainzón;1077;542;535
50;Zaragoza;007;Aladrén;52;34;18
50;Zaragoza;008;Alagón;7163;3572;3591
50;Zaragoza;009;Alarba;124;71;53
50;Zaragoza;010;Alberite de San Juan;69;40;29
50;Zaragoza;011;Albeta;133;70;63
50;Zaragoza;012;Alborge;107;56;51
50;Zaragoza;013;Alcalá de Ebro;246;118;128
50;Zaragoza;014;Alcalá de Moncayo;143;84;59
50;Zaragoza;015;Alconchel de Ariza;62;37;25
50;Zaragoza;016;Aldehuela de Liestos;48;29;19
50;Zaragoza;017;Alfajarín;2315;1191;1124
50;Zaragoza;018;Alfamén;1446;756;690
50;Zaragoza;019;Alforque;68;35;33
50;Zaragoza;020;Alhama de Aragón;1020;537;483
50;Zaragoza;021;Almochuel;25;12;13
50;Zaragoza;022;Almolda, La;553;277;276
50;Zaragoza;023;Almonacid de la Cuba;243;120;123
50;Zaragoza;024;Almonacid de la Sierra;735;404;331
50;Zaragoza;025;Almunia de Doña Godina, La;7951;4089;3862
50;Zaragoza;026;Alpartir;555;284;271
50;Zaragoza;027;Ambel;254;124;130
50;Zaragoza;028;Anento;106;68;38
50;Zaragoza;029;Aniñón;706;383;323
50;Zaragoza;030;Añón de Moncayo;212;129;83
50;Zaragoza;031;Aranda de Moncayo;152;96;56
50;Zaragoza;032;Arándiga;302;159;143
50;Zaragoza;033;Ardisa;70;43;27
50;Zaragoza;034;Ariza;1115;575;540
50;Zaragoza;035;Artieda;80;47;33
50;Zaragoza;036;Asín;110;58;52
50;Zaragoza;037;Atea;151;93;58
50;Zaragoza;038;Ateca;1762;916;846
50;Zaragoza;039;Azuara;540;303;237
50;Zaragoza;040;Badules;85;47;38
50;Zaragoza;041;Bagüés;17;10;7
50;Zaragoza;042;Balconchán;16;6;10
50;Zaragoza;043;Bárboles;293;157;136
50;Zaragoza;044;Bardallur;254;122;132
50;Zaragoza;045;Belchite;1505;756;749
50;Zaragoza;046;Belmonte de Gracián;197;111;86
50;Zaragoza;047;Berdejo;47;32;15
50;Zaragoza;048;Berrueco;34;21;13
50;Zaragoza;901;Biel;154;96;58
50;Zaragoza;050;Bijuesca;94;63;31
50;Zaragoza;051;Biota;941;476;465
50;Zaragoza;052;Bisimbre;92;52;40
50;Zaragoza;053;Boquiñeni;787;398;389
50;Zaragoza;054;Bordalba;56;36;20
50;Zaragoza;055;Borja;4969;2534;2435
50;Zaragoza;056;Botorrita;488;269;219
50;Zaragoza;057;Brea de Aragón;1609;823;786
50;Zaragoza;058;Bubierca;66;34;32
50;Zaragoza;059;Bujaraloz;985;504;481
50;Zaragoza;060;Bulbuente;221;120;101
50;Zaragoza;061;Bureta;214;109;105
50;Zaragoza;062;Burgo de Ebro, El;2436;1233;1203
50;Zaragoza;063;Buste, El;66;36;30
50;Zaragoza;064;Cabañas de Ebro;505;269;236
50;Zaragoza;065;Cabolafuente;33;19;14
50;Zaragoza;066;Cadrete;4032;2137;1895
50;Zaragoza;067;Calatayud;20024;9902;10122
50;Zaragoza;068;Calatorao;2881;1493;1388
50;Zaragoza;069;Calcena;72;42;30
50;Zaragoza;070;Calmarza;57;31;26
50;Zaragoza;071;Campillo de Aragón;147;82;65
50;Zaragoza;072;Carenas;213;116;97
50;Zaragoza;073;Cariñena;3302;1676;1626
50;Zaragoza;074;Caspe;9748;5093;4655
50;Zaragoza;075;Castejón de Alarba;91;58;33
50;Zaragoza;076;Castejón de las Armas;87;49;38
50;Zaragoza;077;Castejón de Valdejasa;210;105;105
50;Zaragoza;078;Castiliscar;263;137;126
50;Zaragoza;079;Cervera de la Cañada;271;151;120
50;Zaragoza;080;Cerveruela;33;22;11
50;Zaragoza;081;Cetina;593;309;284
50;Zaragoza;092;Chiprana;523;277;246
50;Zaragoza;093;Chodes;104;58;46
50;Zaragoza;082;Cimballa;97;48;49
50;Zaragoza;083;Cinco Olivas;106;51;55
50;Zaragoza;084;Clarés de Ribota;66;37;29
50;Zaragoza;085;Codo;201;106;95
50;Zaragoza;086;Codos;234;150;84
50;Zaragoza;087;Contamina;37;21;16
50;Zaragoza;088;Cosuenda;364;193;171
50;Zaragoza;089;Cuarte de Huerva;13303;6792;6511
50;Zaragoza;090;Cubel;155;75;80
50;Zaragoza;091;Cuerlas, Las;41;21;20
50;Zaragoza;094;Daroca;1983;972;1011
50;Zaragoza;095;Ejea de los Caballeros;16783;8562;8221
50;Zaragoza;096;Embid de Ariza;37;20;17
50;Zaragoza;098;Encinacorba;178;97;81
50;Zaragoza;099;Épila;4386;2282;2104
50;Zaragoza;100;Erla;342;175;167
50;Zaragoza;101;Escatrón;1051;522;529
50;Zaragoza;102;Fabara;1125;612;513
50;Zaragoza;104;Farlete;379;183;196
50;Zaragoza;105;Fayón;379;197;182
50;Zaragoza;106;Fayos, Los;139;74;65
50;Zaragoza;107;Figueruelas;1259;629;630
50;Zaragoza;108;Fombuena;56;36;20
50;Zaragoza;109;Frago, El;99;61;38
50;Zaragoza;110;Frasno, El;380;216;164
50;Zaragoza;111;Fréscano;204;113;91
50;Zaragoza;113;Fuendejalón;778;422;356
50;Zaragoza;114;Fuendetodos;145;80;65
50;Zaragoza;115;Fuentes de Ebro;4504;2325;2179
50;Zaragoza;116;Fuentes de Jiloca;231;122;109
50;Zaragoza;117;Gallocanta;152;87;65
50;Zaragoza;118;Gallur;2596;1301;1295
50;Zaragoza;119;Gelsa;1013;535;478
50;Zaragoza;120;Godojos;54;30;24
50;Zaragoza;121;Gotor;318;165;153
50;Zaragoza;122;Grisel;74;43;31
50;Zaragoza;123;Grisén;589;302;287
50;Zaragoza;124;Herrera de los Navarros;506;278;228
50;Zaragoza;125;Ibdes;404;208;196
50;Zaragoza;126;Illueca;2924;1451;1473
50;Zaragoza;128;Isuerre;31;19;12
50;Zaragoza;129;Jaraba;280;152;128
50;Zaragoza;130;Jarque de Moncayo;435;231;204
50;Zaragoza;131;Jaulín;235;128;107
50;Zaragoza;132;Joyosa, La;1073;552;521
50;Zaragoza;133;Lagata;111;59;52
50;Zaragoza;134;Langa del Castillo;121;63;58
50;Zaragoza;135;Layana;97;52;45
50;Zaragoza;136;Lécera;633;345;288
50;Zaragoza;138;Lechón;51;29;22
50;Zaragoza;137;Leciñena;1155;588;567
50;Zaragoza;139;Letux;364;199;165
50;Zaragoza;140;Litago;161;92;69
50;Zaragoza;141;Lituénigo;120;62;58
50;Zaragoza;142;Lobera de Onsella;28;15;13
50;Zaragoza;143;Longares;811;478;333
50;Zaragoza;144;Longás;31;21;10
50;Zaragoza;146;Lucena de Jalón;240;130;110
50;Zaragoza;147;Luceni;956;488;468
50;Zaragoza;148;Luesia;288;160;128
50;Zaragoza;149;Luesma;35;21;14
50;Zaragoza;150;Lumpiaque;814;422;392
50;Zaragoza;151;Luna;698;367;331
50;Zaragoza;152;Maella;1985;1076;909
50;Zaragoza;153;Magallón;1128;576;552
50;Zaragoza;154;Mainar;155;88;67
50;Zaragoza;155;Malanquilla;92;60;32
50;Zaragoza;156;Maleján;259;133;126
50;Zaragoza;160;Mallén;3035;1577;1458
50;Zaragoza;157;Malón;356;180;176
50;Zaragoza;159;Maluenda;922;452;470
50;Zaragoza;161;Manchones;114;61;53
50;Zaragoza;162;Mara;168;83;85
50;Zaragoza;163;María de Huerva;5812;2961;2851
50;Zaragoza;902;Marracos;86;53;33
50;Zaragoza;164;Mediana de Aragón;461;231;230
50;Zaragoza;165;Mequinenza;2324;1180;1144
50;Zaragoza;166;Mesones de Isuela;264;133;131
50;Zaragoza;167;Mezalocha;238;138;100
50;Zaragoza;168;Mianos;30;17;13
50;Zaragoza;169;Miedes de Aragón;433;234;199
50;Zaragoza;170;Monegrillo;405;227;178
50;Zaragoza;171;Moneva;97;56;41
50;Zaragoza;172;Monreal de Ariza;200;117;83
50;Zaragoza;173;Monterde;157;102;55
50;Zaragoza;174;Montón;94;54;40
50;Zaragoza;175;Morata de Jalón;1079;531;548
50;Zaragoza;176;Morata de Jiloca;302;172;130
50;Zaragoza;177;Morés;323;172;151
50;Zaragoza;178;Moros;343;178;165
50;Zaragoza;179;Moyuela;280;156;124
50;Zaragoza;180;Mozota;122;61;61
50;Zaragoza;181;Muel;1378;701;677
50;Zaragoza;182;Muela, La;5784;3022;2762
50;Zaragoza;183;Munébrega;371;201;170
50;Zaragoza;184;Murero;98;58;40
50;Zaragoza;185;Murillo de Gállego;183;107;76
50;Zaragoza;186;Navardún;38;23;15
50;Zaragoza;187;Nigüella;62;38;24
50;Zaragoza;188;Nombrevilla;31;19;12
50;Zaragoza;189;Nonaspe;961;519;442
50;Zaragoza;190;Novallas;830;440;390
50;Zaragoza;191;Novillas;532;268;264
50;Zaragoza;192;Nuévalos;310;173;137
50;Zaragoza;193;Nuez de Ebro;837;419;418
50;Zaragoza;194;Olvés;104;62;42
50;Zaragoza;195;Orcajo;58;36;22
50;Zaragoza;196;Orera;114;60;54
50;Zaragoza;197;Orés;114;69;45
50;Zaragoza;198;Oseja;53;33;20
50;Zaragoza;199;Osera de Ebro;386;193;193
50;Zaragoza;200;Paniza;609;327;282
50;Zaragoza;201;Paracuellos de Jiloca;592;314;278
50;Zaragoza;202;Paracuellos de la Ribera;143;73;70
50;Zaragoza;203;Pastriz;1297;620;677
50;Zaragoza;204;Pedrola;3568;1863;1705
50;Zaragoza;205;Pedrosas, Las;87;44;43
50;Zaragoza;206;Perdiguera;572;305;267
50;Zaragoza;207;Piedratajada;95;51;44
50;Zaragoza;208;Pina de Ebro;2362;1212;1150
50;Zaragoza;209;Pinseque;3973;2050;1923
50;Zaragoza;210;Pintanos, Los;37;23;14
50;Zaragoza;211;Plasencia de Jalón;306;174;132
50;Zaragoza;212;Pleitas;34;14;20
50;Zaragoza;213;Plenas;106;54;52
50;Zaragoza;214;Pomer;22;14;8
50;Zaragoza;215;Pozuel de Ariza;21;12;9
50;Zaragoza;216;Pozuelo de Aragón;296;159;137
50;Zaragoza;217;Pradilla de Ebro;563;298;265
50;Zaragoza;218;Puebla de Albortón;118;73;45
50;Zaragoza;219;Puebla de Alfindén, La;6303;3224;3079
50;Zaragoza;220;Puendeluna;44;27;17
50;Zaragoza;221;Purujosa;35;25;10
50;Zaragoza;222;Quinto;1939;977;962
50;Zaragoza;223;Remolinos;1086;554;532
50;Zaragoza;224;Retascón;67;40;27
50;Zaragoza;225;Ricla;2847;1517;1330
50;Zaragoza;227;Romanos;128;65;63
50;Zaragoza;228;Rueda de Jalón;310;170;140
50;Zaragoza;229;Ruesca;78;39;39
50;Zaragoza;241;Sabiñán;723;388;335
50;Zaragoza;230;Sádaba;1324;671;653
50;Zaragoza;231;Salillas de Jalón;315;155;160
50;Zaragoza;232;Salvatierra de Esca;199;93;106
50;Zaragoza;233;Samper del Salz;110;62;48
50;Zaragoza;234;San Martín de la Virgen de Moncayo;277;155;122
50;Zaragoza;235;San Mateo de Gállego;3234;1668;1566
50;Zaragoza;236;Santa Cruz de Grío;116;70;46
50;Zaragoza;237;Santa Cruz de Moncayo;130;70;60
50;Zaragoza;238;Santa Eulalia de Gállego;95;52;43
50;Zaragoza;239;Santed;63;39;24
50;Zaragoza;240;Sástago;1154;578;576
50;Zaragoza;242;Sediles;102;59;43
50;Zaragoza;243;Sestrica;352;202;150
50;Zaragoza;244;Sierra de Luna;268;139;129
50;Zaragoza;245;Sigüés;83;44;39
50;Zaragoza;246;Sisamón;29;18;11
50;Zaragoza;247;Sobradiel;1096;523;573
50;Zaragoza;248;Sos del Rey Católico;590;312;278
50;Zaragoza;249;Tabuenca;314;181;133
50;Zaragoza;250;Talamantes;64;30;34
50;Zaragoza;251;Tarazona;10533;5256;5277
50;Zaragoza;252;Tauste;6912;3451;3461
50;Zaragoza;253;Terrer;447;240;207
50;Zaragoza;254;Tierga;186;101;85
50;Zaragoza;255;Tobed;214;112;102
50;Zaragoza;256;Torralba de los Frailes;79;43;36
50;Zaragoza;257;Torralba de Ribota;174;98;76
50;Zaragoza;258;Torralbilla;55;34;21
50;Zaragoza;259;Torrehermosa;59;33;26
50;Zaragoza;260;Torrelapaja;32;21;11
50;Zaragoza;261;Torrellas;250;128;122
50;Zaragoza;262;Torres de Berrellén;1446;739;707
50;Zaragoza;263;Torrijo de la Cañada;199;116;83
50;Zaragoza;264;Tosos;183;104;79
50;Zaragoza;265;Trasmoz;86;51;35
50;Zaragoza;266;Trasobares;122;76;46
50;Zaragoza;267;Uncastillo;636;301;335
50;Zaragoza;268;Undués de Lerda;50;28;22
50;Zaragoza;269;Urrea de Jalón;418;234;184
50;Zaragoza;270;Urriés;39;21;18
50;Zaragoza;271;Used;269;145;124
50;Zaragoza;272;Utebo;18691;9287;9404
50;Zaragoza;274;Val de San Martín;66;39;27
50;Zaragoza;273;Valdehorna;33;18;15
50;Zaragoza;275;Valmadrid;117;71;46
50;Zaragoza;276;Valpalmas;140;68;72
50;Zaragoza;277;Valtorres;61;27;34
50;Zaragoza;278;Velilla de Ebro;215;116;99
50;Zaragoza;279;Velilla de Jiloca;87;42;45
50;Zaragoza;280;Vera de Moncayo;338;174;164
50;Zaragoza;281;Vierlas;77;40;37
50;Zaragoza;283;Villadoz;92;51;41
50;Zaragoza;284;Villafeliche;166;90;76
50;Zaragoza;285;Villafranca de Ebro;833;416;417
50;Zaragoza;286;Villalba de Perejil;96;48;48
50;Zaragoza;287;Villalengua;313;172;141
50;Zaragoza;903;Villamayor de Gállego;2720;1361;1359
50;Zaragoza;288;Villanueva de Gállego;4720;2368;2352
50;Zaragoza;290;Villanueva de Huerva;443;229;214
50;Zaragoza;289;Villanueva de Jiloca;54;27;27
50;Zaragoza;291;Villar de los Navarros;106;60;46
50;Zaragoza;292;Villarreal de Huerva;274;152;122
50;Zaragoza;293;Villarroya de la Sierra;446;234;212
50;Zaragoza;294;Villarroya del Campo;74;40;34
50;Zaragoza;282;Vilueña, La;72;35;37
50;Zaragoza;295;Vistabella;49;28;21
50;Zaragoza;296;Zaida, La;435;219;216
50;Zaragoza;297;Zaragoza;674997;322626;352371
50;Zaragoza;298;Zuera;8565;4442;4123
